Summit
An Interactive Fiction by Dustin Palea
Release 1 / Serial number 210518 / Inform 7 build 6M62 (I6/v6.34 lib 6/12N) SD

After months of daydreaming, you finally arrive at Mt. Aconcagua - ready to summit your first mountain. Reach the top, collect your bragging rights, and come back down ALIVE.

Basecamp
Plaza Argentina Base Camp (4200m) for Mt. Aconcagua. The trail up to the summit begins here. It's a dangerous, but non-technical climb. There is a collection of ragtag temporary structures that form the Guardia's seasonal presence at the less popular Polish Route base camp. Brightly colored tents dot the plateau. The Polish Glacier looms in the distance, and a swift stream - the headwaters of the Vacas river flow from its base. There is an outhouse on the edge of camp. The weekly helicopter retrieval of the 50 gallon drum of waste is a highlight and one of the only things that marks civilized time.

Use your map to help you decide what supplies you should take on your ascent.

--- Down here, each action requires 1 energy point. And without energy, your health will decrease 11 points per action. ---

You can see 'Basecamp Chest' (closed) here.

I beg your pardon?

* * *

>ACTIONS
Actions listing on.

>go to Camp1
[going by name Camp1]
Are you sure you want to go to Camp1?

>move
('Basecamp Chest')
[pushing 'Basecamp Chest']
It is fixed in place.
[pushing 'Basecamp Chest' - failed the can't push what's fixed in place rule]

Energy: 99%  Health: 100%

>travel
That's not a verb I recognise.

>go to camp1
You can't see any such thing.

>go to Camp1
You can't see any such thing.

>go n
[going north]

Camp1
Camp 1 (4900m)  At 16,076 feet above sea level, Camp 1 is higher than most people have every climbed. It is higher than any peak in North America. It is just 1000 feet lower than Everest Base Camp in Nepal. Camp 1 is located at the top of the trail on a plateau. Aconcagua is not visible from here, but its sister, Mt. Ameguino's snowy peak looms above you. The camp is located several hundred meters from the glacial stream. There is no outhouse (you must bury your waste, away from any area that could contaminate the stream). Carrying water from the stream to boil for hydration and cooking is required. You can only carry part of what you need to Camp 1 on your first trip, so you must plan carefully. Climbers stay one night in Camp 1, then return to Base Camp for more supplies. You have to bring the bare essentials - tent, sleeping bag, camp stove, food. You don't immediately need ice climbing equipment - mountaineering boots, crampons, ice ax, harness, helmet, rope. But you will eventually need to bring up to Camp 1, as it's needed at higher elevations.

--- Here, each action requires 2 energy points. And without energy, your health will decrease 12 points per action. ---

[going north - succeeded]

Energy: 97%  Health: 100%

>look
[looking]
Camp1
Camp 1 (4900m)  At 16,076 feet above sea level, Camp 1 is higher than most people have every climbed. It is higher than any peak in North America. It is just 1000 feet lower than Everest Base Camp in Nepal. Camp 1 is located at the top of the trail on a plateau. Aconcagua is not visible from here, but its sister, Mt. Ameguino's snowy peak looms above you. The camp is located several hundred meters from the glacial stream. There is no outhouse (you must bury your waste, away from any area that could contaminate the stream). Carrying water from the stream to boil for hydration and cooking is required. You can only carry part of what you need to Camp 1 on your first trip, so you must plan carefully. Climbers stay one night in Camp 1, then return to Base Camp for more supplies. You have to bring the bare essentials - tent, sleeping bag, camp stove, food. You don't immediately need ice climbing equipment - mountaineering boots, crampons, ice ax, harness, helmet, rope. But you will eventually need to bring up to Camp 1, as it's needed at higher elevations.

--- Here, each action requires 2 energy points. And without energy, your health will decrease 12 points per action. ---

[looking - succeeded]

Energy: 95%  Health: 100%

* * *

>go to Camp1
[going by name Camp1]
Are you sure you want to go to Camp1?

>yes
You walk to Camp1.

[(1) looking]
Camp1
Camp 1 (4900m)  At 16,076 feet above sea level, Camp 1 is higher than most people have every climbed. It is higher than any peak in North America. It is just 1000 feet lower than Everest Base Camp in Nepal. Camp 1 is located at the top of the trail on a plateau. Aconcagua is not visible from here, but its sister, Mt. Ameguino's snowy peak looms above you. The camp is located several hundred meters from the glacial stream. There is no outhouse (you must bury your waste, away from any area that could contaminate the stream). Carrying water from the stream to boil for hydration and cooking is required. You can only carry part of what you need to Camp 1 on your first trip, so you must plan carefully. Climbers stay one night in Camp 1, then return to Base Camp for more supplies. You have to bring the bare essentials - tent, sleeping bag, camp stove, food. You don't immediately need ice climbing equipment - mountaineering boots, crampons, ice ax, harness, helmet, rope. But you will eventually need to bring up to Camp 1, as it's needed at higher elevations.

--- Here, each action requires 2 energy points. And without energy, your health will decrease 12 points per action. ---

[(1) looking - succeeded]

[going by name Camp1 - succeeded]

Energy: 98%  Health: 100%

>go to basecamp
[going by name Basecamp]
Are you sure you want to go to Basecamp?

>no
[going by name Basecamp - succeeded]

Energy: 96%  Health: 100%

* * *

>ACTIONS
Actions listing on.

>open chest
[opening 'Basecamp Chest']
You open 'Basecamp Chest', revealing a water bottle, an ice axe, a tent, a backpack and an orange.
[opening 'Basecamp Chest' - succeeded]

Load: 0%  Energy: 99%  Health: 100%

>take orange
[taking the orange]
Taken.
[taking the orange - succeeded]

Energy: 98%  Health: 100%

>i
[taking inventory]
You are carrying:
  an orange

[taking inventory - succeeded]

Energy: 97%  Health: 100%

>x i
You can't see any such thing.

>x inventory
You can't see any such thing.

>undo
Basecamp
[Previous turn undone.]

>go to camp1
[going by name Camp1]
orangeeeeeAre you sure you want to go to Camp1? This hike will require 20 energy.

* * *

>open chest
[opening 'Basecamp Chest']
You open 'Basecamp Chest', revealing a water bottle, an ice axe, a tent, a backpack and an orange.
[opening 'Basecamp Chest' - succeeded]

Load: 0%  Energy: 99%  Health: 100%

>take tent
[taking the tent]
Taken.
[taking the tent - succeeded]

Load: 0%  Energy: 98%  Health: 100%

>take water bottle
[taking the water bottle]
You're carrying too many things already.
[taking the water bottle - failed the can't exceed carrying capacity rule]

Load: 0%  Energy: 97%  Health: 100%

* * *

>ACTIONSS
That's not a verb I recognise.

>ACTIONS
Actions listing on.

>go to Basecamp
That noun did not make sense in this context.

>go to Camp1
[going by name Camp1]
Are you sure you want to go to Camp1?

>yes
Ooookay
You walk to Camp1.

[(1) looking]
Camp1
Camp 1 (4900m)  At 16,076 feet above sea level, Camp 1 is higher than most people have every climbed. It is higher than any peak in North America. It is just 1000 feet lower than Everest Base Camp in Nepal. Camp 1 is located at the top of the trail on a plateau. Aconcagua is not visible from here, but its sister, Mt. Ameguino's snowy peak looms above you. The camp is located several hundred meters from the glacial stream. There is no outhouse (you must bury your waste, away from any area that could contaminate the stream). Carrying water from the stream to boil for hydration and cooking is required. You can only carry part of what you need to Camp 1 on your first trip, so you must plan carefully. Climbers stay one night in Camp 1, then return to Base Camp for more supplies. You have to bring the bare essentials - tent, sleeping bag, camp stove, food. You don't immediately need ice climbing equipment - mountaineering boots, crampons, ice ax, harness, helmet, rope. But you will eventually need to bring up to Camp 1, as it's needed at higher elevations.

--- Here, each action requires 2 energy points. And without energy, your health will decrease 12 points per action. ---

[(1) looking - succeeded]

[going by name Camp1 - succeeded]

Energy: 98%  Health: 100%

>go to basecamp
[going by name Basecamp]
Are you sure you want to go to Basecamp?

>no
You walk to Basecamp.

[(1) looking]
Basecamp
Plaza Argentina Base Camp (4200m) for Mt. Aconcagua. The trail up to the summit begins here. It's a dangerous, but non-technical climb. There is a collection of ragtag temporary structures that form the Guardia's seasonal presence at the less popular Polish Route base camp. Brightly colored tents dot the plateau. The Polish Glacier looms in the distance, and a swift stream - the headwaters of the Vacas river flow from its base. There is an outhouse on the edge of camp. The weekly helicopter retrieval of the 50 gallon drum of waste is a highlight and one of the only things that marks civilized time.

--- Here, each action requires 1 energy point. And without energy, your health will decrease 11 points per action. ---

You can see 'Basecamp Chest' (closed) here.

[(1) looking - succeeded]

[going by name Basecamp - succeeded]

Energy: 97%  Health: 100%

* * *

>BRICE NAMNAMA TO THE MOON
That's not a verb I recognise.

>open chest
You open 'Basecamp Chest', revealing a water bottle, an ice axe, a tent, a backpack and an orange.

Load: 0%  Energy: 99%  Health: 100%

>take water bottle
Make sure you're wearing a backpack.

Taken.

Load: 0%  Energy: 98%  Health: 100%

* * *

>OPEN CHEST
You open 'Basecamp Chest', revealing a water bottle, an ice axe, a tent, a backpack and an orange.

Load: 0%  Energy: 99%  Health: 100%

>take orange
You'll probably need a backpack to hold all that...

Load: 0%  Energy: 98%  Health: 100%

* * *

>action
That's not a verb I recognise.

>ACTIONS
Actions listing on.

>S
[going south]
You can't go that way.
[going south - failed the can't go that way rule]

Energy: 99%  Health: 100%

>go basecamp
You can't see any such thing.

>go to basecamp
You can't see any such thing.

>go to camp1
You can't see any such thing.

* * *

>chest
That's not a verb I recognise.

* * *

>diagnose self
Your health is at 100%. You have $5000.

>diagnose me
Your health is at 100%.

>check self
As good-looking as ever.

* * *

>drink water
You can't see any such thing.

>open chest
You open 'Basecamp Chest', revealing a water bottle, an ice axe, a tent and an orange.

Load: 0%  Energy: 99%  Health: 100%

>take all
water bottle: Taken.
ice axe: Taken.
tent: Taken.
orange: Taken.

Load: 0%  Energy: 98%  Health: 100%

>drink water
Aaaaahh! Very refreshing.

Load: 0%  Energy: 99%  Health: 100%

>l
Basecamp
Plaza Argentina Base Camp (4200m) for Mt. Aconcagua. The trail up to the summit begins here. It's a dangerous, but non-technical climb. There is a collection of ragtag temporary structures that form the Guardia's seasonal presence at the less popular Polish Route base camp. Brightly colored tents dot the plateau. The Polish Glacier looms in the distance, and a swift stream - the headwaters of the Vacas river flow from its base. There is an outhouse on the edge of camp. The weekly helicopter retrieval of the 50 gallon drum of waste is a highlight and one of the only things that marks civilized time.

--- Down here, each action requires 1 energy point. And without energy, your health will decrease 11 points per action. ---

You can see 'Basecamp Chest' (empty) here.

Load: 0%  Energy: 98%  Health: 100%

* * *

>eat orange
You can't see any such thing.

>x chest1
You see nothing special about Chest1.

>open chest1
You open Chest1, revealing an orange.

>eat orange
You're not hungry right now.

* * *

>go Camp1
You can't see any such thing.

>go to Camp1
You walk to Camp1.

Camp1
Camp 1 (4900m)  At 16,076 feet above sea level, Camp 1 is higher than most people have every climbed. It is higher than any peak in North America. It is just 1000 feet lower than Everest Base Camp in Nepal. Camp 1 is located at the top of the trail on a plateau. Aconcagua is not visible from here, but its sister, Mt. Ameguino's snowy peak looms above you. The camp is located several hundred meters from the glacial stream. There is no outhouse (you must bury your waste, away from any area that could contaminate the stream). Carrying water from the stream to boil for hydration and cooking is required. You can only carry part of what you need to Camp 1 on your first trip, so you must plan carefully. Climbers stay one night in Camp 1, then return to Base Camp for more supplies. You have to bring the bare essentials - tent, sleeping bag, camp stove, food. You don't immediately need ice climbing equipment - mountaineering boots, crampons, ice ax, harness, helmet, rope. But you will eventually need to bring up to Camp 1, as it's needed at higher elevations.

--- Here, each action requires 2 energy points. And without energy, your health will decrease 12 points per action. ---

Energy: 98%  Health: 100%

* * *

>go n
Before heading up to Camp1, you should at least bring food, water, shelter, and an ice axe.

Current Load: 0%    Max Load: 100%            Energy: 99%    Health: 100%

>go s
There's no time for wandering around. We have a mountain to tackle - South to North and then North to South.

Load: 0%  Energy: 98%  Health: 100%

>go north
Load: 0%  Energy: 97%  Health: 100%

>go w
There's no time for wandering around. We have a mountain to tackle - South to North and then North to South.

Load: 0%  Energy: 96%  Health: 100%

>l
Basecamp
Plaza Argentina Base Camp (4200m) for Mt. Aconcagua. The trail up to the summit begins here. It's a dangerous, but non-technical climb. There is a collection of ragtag temporary structures that form the Guardia's seasonal presence at the less popular Polish Route base camp. Brightly colored tents dot the plateau. The Polish Glacier looms in the distance, and a swift stream - the headwaters of the Vacas river flow from its base. There is an outhouse on the edge of camp. The weekly helicopter retrieval of the 50 gallon drum of waste is a highlight and one of the only things that marks civilized time.

--- Here, each action requires 1 energy point. And without energy, your health will decrease 11 points per action. ---

You can see 'Basecamp Chest' (closed) here.

Load: 0%  Energy: 95%  Health: 100%

* * *

>go n
Before heading up to Camp1, you should at least bring food, water, shelter, and an ice axe.

Current Load: 0%    Max Load: 100%            Energy: 99%    Health: 100%

>go to Basecamp
You walk to Basecamp.

Basecamp
Plaza Argentina Base Camp (4200m) for Mt. Aconcagua. The trail up to the summit begins here. It's a dangerous, but non-technical climb. There is a collection of ragtag temporary structures that form the Guardia's seasonal presence at the less popular Polish Route base camp. Brightly colored tents dot the plateau. The Polish Glacier looms in the distance, and a swift stream - the headwaters of the Vacas river flow from its base. There is an outhouse on the edge of camp. The weekly helicopter retrieval of the 50 gallon drum of waste is a highlight and one of the only things that marks civilized time.

--- Here, each action requires 1 energy point. And without energy, your health will decrease 11 points per action. ---

You can see 'Basecamp Chest' (closed) here.

Energy: 97%  Health: 100%

* * *

>go n
Before heading up to Camp1, you should at least bring food, water, shelter, and an ice axe.

Current Load: 0%    Max Load: 100%            Energy: 99%    Health: 100%

>l
Basecamp
Plaza Argentina Base Camp (4200m) for Mt. Aconcagua. The trail up to the summit begins here. It's a dangerous, but non-technical climb. There is a collection of ragtag temporary structures that form the Guardia's seasonal presence at the less popular Polish Route base camp. Brightly colored tents dot the plateau. The Polish Glacier looms in the distance, and a swift stream - the headwaters of the Vacas river flow from its base. There is an outhouse on the edge of camp. The weekly helicopter retrieval of the 50 gallon drum of waste is a highlight and one of the only things that marks civilized time.

--- Here, each action requires 1 energy point. And without energy, your health will decrease 11 points per action. ---

You can see 'Basecamp Chest' (closed) here.

Load: 0%  Energy: 98%  Health: 100%

>go to camp1
hereYou should at least bring food, water, shelter, and an ice axe.

Load: 0%  Energy: 97%  Health: 100%

* * *

>go n
Before heading up to Camp1, you should at least bring food, water, shelter, and an ice axe.

Current Load: 0%    Max Load: 100%            Energy: 99%    Health: 100%

>take water, chicken, axe, tent
You can't see any such thing.

>open chest
You open 'Basecamp Chest', revealing an orange, a cliff bar, beef jerky, chicken jerky, a water bottle, an ice axe, crampons, a rope, a first aid kit, a tent and a chemical warming pack.

Current Load: 0%    Max Load: 100%            Energy: 98%    Health: 100%

>take water, chicken, axe, tent
water bottle: Taken.
chicken jerky: Taken.
ice axe: Taken.
tent: Taken.

Current Load: 60%    Max Load: 100%            Energy: 97%    Health: 100%

>go n
Are you sure you want to go to Camp1? This hike will require 20 energy.

>y
You make the trek to Camp1 and arrive late in the evening.

Camp1
Camp 1 (4900m)  At 16,076 feet above sea level, Camp 1 is higher than most people have every climbed. It is higher than any peak in North America. It is just 1000 feet lower than Everest Base Camp in Nepal. Camp 1 is located at the top of the trail on a plateau. Aconcagua is not visible from here, but its sister, Mt. Ameguino's snowy peak looms above you. The camp is located several hundred meters from the glacial stream. There is no outhouse (you must bury your waste, away from any area that could contaminate the stream).

--- Here, each action requires 2 energy points. And without energy, your health will decrease 12 points per action. ---

Immediately ahead, you see the glacier blocking your path... good thing you brought climbing gear... right?

Current Load: 60%    Max Load: 100%            Energy: 75%    Health: 100%

>l
Camp1
Camp 1 (4900m)  At 16,076 feet above sea level, Camp 1 is higher than most people have every climbed. It is higher than any peak in North America. It is just 1000 feet lower than Everest Base Camp in Nepal. Camp 1 is located at the top of the trail on a plateau. Aconcagua is not visible from here, but its sister, Mt. Ameguino's snowy peak looms above you. The camp is located several hundred meters from the glacial stream. There is no outhouse (you must bury your waste, away from any area that could contaminate the stream).

--- Here, each action requires 2 energy points. And without energy, your health will decrease 12 points per action. ---

Current Load: 60%    Max Load: 100%            Energy: 73%    Health: 100%

* * *

>go north
Are you sure you want to go to the north, 
*** Run-time problem P10: Since the north is not allowed the property "energydecline", it is against the rules to try to use it.

0?

Camp1
Camp 1 (4900m)  At 16,076 feet above sea level, Camp 1 is higher than most people have every climbed. It is higher than any peak in North America. It is just 1000 feet lower than Everest Base Camp in Nepal. Camp 1 is located at the top of the trail on a plateau. Aconcagua is not visible from here, but its sister, Mt. Ameguino's snowy peak looms above you. The camp is located several hundred meters from the glacial stream. There is no outhouse (you must bury your waste, away from any area that could contaminate the stream). Carrying water from the stream to boil for hydration and cooking is required. You can only carry part of what you need to Camp 1 on your first trip, so you must plan carefully. Climbers stay one night in Camp 1, then return to Base Camp for more supplies. You have to bring the bare essentials - tent, sleeping bag, camp stove, food. You don't immediately need ice climbing equipment - mountaineering boots, crampons, ice ax, harness, helmet, rope. But you will eventually need to bring up to Camp 1, as it's needed at higher elevations.

--- Here, each action requires 2 energy points. And without energy, your health will decrease 12 points per action. ---

Energy: 98%  Health: 100%

>go north
Camp2
Camp 2 (5850m) Camp 2 is located at the base of visible portions of the Polish Glacier. Below, it retreats under the moraine, but above you, it appears as a both a wall and a river of blue-green ice and white pillars. These are Los Penitentes, statues in ice guarding the glacier. From here, you can see all the way to the Valle de Vacas. Just like with portages from Plaza Argentina to Camp 1, you must make several trips over 3 days from Camp 1 to Camp 2 to haul the rest of your gear. You leave almost nothing behind at Camp 1, except for an emergency shelter tent and some provisions. You have the option of stashing extra water and saving some of your favorite food for the descent.

--- Here, each action requires 5 energy points. And without energy, your health will decrease 15 points per action. ---

* * *

>go s
There's no time for wandering around. We have a mountain to tackle - from South to North and then North to South.

Load: 0%  Energy: 99%  Health: 100%

* * *

>go to Camp1
Are you sure you want to go to Camp1?

>yes
You walk to Camp1.

Camp1
Camp 1 (4900m)  At 16,076 feet above sea level, Camp 1 is higher than most people have every climbed. It is higher than any peak in North America. It is just 1000 feet lower than Everest Base Camp in Nepal. Camp 1 is located at the top of the trail on a plateau. Aconcagua is not visible from here, but its sister, Mt. Ameguino's snowy peak looms above you. The camp is located several hundred meters from the glacial stream. There is no outhouse (you must bury your waste, away from any area that could contaminate the stream). Carrying water from the stream to boil for hydration and cooking is required. You can only carry part of what you need to Camp 1 on your first trip, so you must plan carefully. Climbers stay one night in Camp 1, then return to Base Camp for more supplies. You have to bring the bare essentials - tent, sleeping bag, camp stove, food. You don't immediately need ice climbing equipment - mountaineering boots, crampons, ice ax, harness, helmet, rope. But you will eventually need to bring up to Camp 1, as it's needed at higher elevations.

--- Here, each action requires 2 energy points. And without energy, your health will decrease 12 points per action. ---

Energy: 98%  Health: 100%

* * *

>go to basecamp
That noun did not make sense in this context.

>go to camp1
You should at least bring food, water, shelter, and an ice axe.

>yes
Energy: 99%  Health: 100%

* * *

>go to camp1
You should at least bring food, water, shelter, and an ice axe.

Load: 0%  Energy: 99%  Health: 100%

Please answer yes or no.

* * *

>go to camp1
You should at least bring food, water, shelter, and an ice axe.

Load: 0%  Energy: 99%  Health: 100%

>go north
Camp1
Camp 1 (4900m)  At 16,076 feet above sea level, Camp 1 is higher than most people have every climbed. It is higher than any peak in North America. It is just 1000 feet lower than Everest Base Camp in Nepal. Camp 1 is located at the top of the trail on a plateau. Aconcagua is not visible from here, but its sister, Mt. Ameguino's snowy peak looms above you. The camp is located several hundred meters from the glacial stream. There is no outhouse (you must bury your waste, away from any area that could contaminate the stream). Carrying water from the stream to boil for hydration and cooking is required. You can only carry part of what you need to Camp 1 on your first trip, so you must plan carefully. Climbers stay one night in Camp 1, then return to Base Camp for more supplies. You have to bring the bare essentials - tent, sleeping bag, camp stove, food. You don't immediately need ice climbing equipment - mountaineering boots, crampons, ice ax, harness, helmet, rope. But you will eventually need to bring up to Camp 1, as it's needed at higher elevations.

--- Here, each action requires 2 energy points. And without energy, your health will decrease 12 points per action. ---

Load: 0%  Energy: 97%  Health: 100%

>open chest
You can't see any such thing.

>go n
Camp2
Camp 2 (5850m) Camp 2 is located at the base of visible portions of the Polish Glacier. Below, it retreats under the moraine, but above you, it appears as a both a wall and a river of blue-green ice and white pillars. These are Los Penitentes, statues in ice guarding the glacier. From here, you can see all the way to the Valle de Vacas. Just like with portages from Plaza Argentina to Camp 1, you must make several trips over 3 days from Camp 1 to Camp 2 to haul the rest of your gear. You leave almost nothing behind at Camp 1, except for an emergency shelter tent and some provisions. You have the option of stashing extra water and saving some of your favorite food for the descent.

--- Here, each action requires 5 energy points. And without energy, your health will decrease 15 points per action. ---

Load: 0%  Energy: 92%  Health: 100%

>go n
Camp3
Camp 3 (400m elevation gain). No one stays in Camp 3 for long. It is above the "kill zone" where lack of oxygen and hypoxia can cause rapid deterioration in your mental and physical state. If you decide to use Camp 3, it's only for a quick stop over so you can be up well before sunrise to attempt the summit. You take only the bare essentials: shelter, food, safety equipment, and your climbing gear. You leave your tent and sleeping bag behind, but you won't be staying at Camp 3 after the summit. You will stop to retrieve your equipment, if you survive the summit, but that's it. If you choose to summit from Camp 3, you will have less climbing to do, but you will also be weaker from the extra time at altitude.

--- Here, each action requires 10 energy points. And without energy, your health will decrease 20 points per action. ---

Load: 0%  Energy: 82%  Health: 100%

>go n
Summit
Summit (6962m). The summit of Aconcagua is unremarkable in some ways. It's a rocky outcropping with various markers, cairns and flags placed there by other climbers. You pause, but not for too long, for photographs and to congratulate members of your team for the accomplishment. You know that you are on the highest peak anywhere except for the Himalayas. Now, you must descend before the weather turns or you lose your mind from lack of oxygen.

--- Here, each action requires 10 energy points. And without energy, your health will decrease 20 points per action. ---

Load: 0%  Energy: 72%  Health: 100%

>go s
Camp3
Camp 3 (400m elevation gain). No one stays in Camp 3 for long. It is above the "kill zone" where lack of oxygen and hypoxia can cause rapid deterioration in your mental and physical state. If you decide to use Camp 3, it's only for a quick stop over so you can be up well before sunrise to attempt the summit. You take only the bare essentials: shelter, food, safety equipment, and your climbing gear. You leave your tent and sleeping bag behind, but you won't be staying at Camp 3 after the summit. You will stop to retrieve your equipment, if you survive the summit, but that's it. If you choose to summit from Camp 3, you will have less climbing to do, but you will also be weaker from the extra time at altitude.

--- Here, each action requires 10 energy points. And without energy, your health will decrease 20 points per action. ---

Load: 0%  Energy: 62%  Health: 100%

>go to summit
Are you sure you want to go to Summit? This hike will require 40 energy.

>y
You make the trek to Summit.

Summit
Summit (6962m). The summit of Aconcagua is unremarkable in some ways. It's a rocky outcropping with various markers, cairns and flags placed there by other climbers. You pause, but not for too long, for photographs and to congratulate members of your team for the accomplishment. You know that you are on the highest peak anywhere except for the Himalayas. Now, you must descend before the weather turns or you lose your mind from lack of oxygen.

--- Here, each action requires 10 energy points. And without energy, your health will decrease 20 points per action. ---

Load: 0%  Energy: 52%  Health: 100%

* * *

>go to camp1
You should at least bring food, water, shelter, and an ice axe.

Load: 0%  Energy: 99%  Health: 100%

>open chest
You open 'Basecamp Chest', revealing Waterskin, a tent and an orange.

Energy: 98%  Health: 100%

>take water, tent, orange
Waterskin: Taken.
tent: Taken.
orange: Taken.

Energy: 97%  Health: 100%

>go to camp1
Are you sure you want to go to Camp1? This hike will require 20 energy.

>y
You make the trek to Camp1.

Camp1
Camp 1 (4900m)  At 16,076 feet above sea level, Camp 1 is higher than most people have every climbed. It is higher than any peak in North America. It is just 1000 feet lower than Everest Base Camp in Nepal. Camp 1 is located at the top of the trail on a plateau. Aconcagua is not visible from here, but its sister, Mt. Ameguino's snowy peak looms above you. The camp is located several hundred meters from the glacial stream. There is no outhouse (you must bury your waste, away from any area that could contaminate the stream). Carrying water from the stream to boil for hydration and cooking is required. You can only carry part of what you need to Camp 1 on your first trip, so you must plan carefully. Climbers stay one night in Camp 1, then return to Base Camp for more supplies. You have to bring the bare essentials - tent, sleeping bag, camp stove, food. You don't immediately need ice climbing equipment - mountaineering boots, crampons, ice ax, harness, helmet, rope. But you will eventually need to bring up to Camp 1, as it's needed at higher elevations.

--- Here, each action requires 2 energy points. And without energy, your health will decrease 12 points per action. ---

Energy: 95%  Health: 100%

* * *

>go to camp1
You should at least bring food, water, shelter, and an ice axe.

Load: 0%  Energy: 99%  Health: 100%

>yes
You walk to Camp1.

Camp1
Camp 1 (4900m)  At 16,076 feet above sea level, Camp 1 is higher than most people have every climbed. It is higher than any peak in North America. It is just 1000 feet lower than Everest Base Camp in Nepal. Camp 1 is located at the top of the trail on a plateau. Aconcagua is not visible from here, but its sister, Mt. Ameguino's snowy peak looms above you. The camp is located several hundred meters from the glacial stream. There is no outhouse (you must bury your waste, away from any area that could contaminate the stream). Carrying water from the stream to boil for hydration and cooking is required. You can only carry part of what you need to Camp 1 on your first trip, so you must plan carefully. Climbers stay one night in Camp 1, then return to Base Camp for more supplies. You have to bring the bare essentials - tent, sleeping bag, camp stove, food. You don't immediately need ice climbing equipment - mountaineering boots, crampons, ice ax, harness, helmet, rope. But you will eventually need to bring up to Camp 1, as it's needed at higher elevations.

--- Here, each action requires 2 energy points. And without energy, your health will decrease 12 points per action. ---

Energy: 98%  Health: 100%

>go to basecamp
Are you sure you want to go to Basecamp? This hike will require 15 energy.

>yes
You walk to Basecamp.

Basecamp
Plaza Argentina Base Camp (4200m) for Mt. Aconcagua. The trail up to the summit begins here. It's a dangerous, but non-technical climb. There is a collection of ragtag temporary structures that form the Guardia's seasonal presence at the less popular Polish Route base camp. Brightly colored tents dot the plateau. The Polish Glacier looms in the distance, and a swift stream - the headwaters of the Vacas river flow from its base. There is an outhouse on the edge of camp. The weekly helicopter retrieval of the 50 gallon drum of waste is a highlight and one of the only things that marks civilized time.

--- Here, each action requires 1 energy point. And without energy, your health will decrease 11 points per action. ---

You can see 'Basecamp Chest' (closed) here.

Energy: 97%  Health: 100%

* * *

>heal self
Your health is at 100%. You have $5000.

>heal self
Your health is at 100%. You have $5000.

>hurt self
Your health is at 90%. You have $5000.

>heal self
Your health is at 90%. You have $5000.

>hurt self
Your health is at 80%. You have $5000.

>heal self
Your health is at 90%. You have $5000.

* * *

>hit gladiator
You can't see any such thing.

>hit gladiator / g / g / g
You can't see any such thing.

>check current health
You can't see any such thing.

* * *

>hurt self
Your health is at 90%. You have $5000.

>heal self
Your health is at 100%. You have $5000.

>heal self
Your health is at 110%. You have $5000.

* * *

>hurt self
Your health is at 90%. You have $5000.

>hurt self
Your health is at 80%. You have $5000.

* * *

>i
You are carrying nothing.

Load: 0%  Energy: 99%  Health: 100%

>open chest
You open 'Basecamp Chest', revealing a water bottle, an ice axe, a tent, a backpack and an orange.

Load: 0%  Energy: 98%  Health: 100%

>take bottle
Taken.

Load: 0%  Energy: 97%  Health: 100%

>take axe
Taken.

Load: 0%  Energy: 96%  Health: 100%

>take tent
You'll probably need a backpack to hold all that...

Load: 0%  Energy: 95%  Health: 100%

* * *

>i gob
I only understood you as far as wanting to take inventory.

>i
You are carrying nothing.

>x
What do you want to examine?

>x gob
You can't see any such thing.

* * *

>l
Basecamp
Plaza Argentina Base Camp (4200m) for Mt. Aconcagua. The trail up to the summit begins here. It's a dangerous, but non-technical climb. There is a collection of ragtag temporary structures that form the Guardia's seasonal presence at the less popular Polish Route base camp. Brightly colored tents dot the plateau. The Polish Glacier looms in the distance, and a swift stream - the headwaters of the Vacas river flow from its base. There is an outhouse on the edge of camp. The weekly helicopter retrieval of the 50 gallon drum of waste is a highlight and one of the only things that marks civilized time.

--- Down here, each action requires 1 energy point. And without energy, your health will decrease 11 points per action. ---

You can see 'Basecamp Chest' (closed) here.

Load: 0%  Energy: 99%  Health: 100%

>go n
You can't go that way.

>go e
BB

>x
What do you want to examine?

>x BB
You can't see any such thing.

* * *

>l
Basecamp
Plaza Argentina Base Camp (4200m) for Mt. Aconcagua. The trail up to the summit begins here. It's a dangerous, but non-technical climb. There is a collection of ragtag temporary structures that form the Guardia's seasonal presence at the less popular Polish Route base camp. Brightly colored tents dot the plateau. The Polish Glacier looms in the distance, and a swift stream - the headwaters of the Vacas river flow from its base. There is an outhouse on the edge of camp. The weekly helicopter retrieval of the 50 gallon drum of waste is a highlight and one of the only things that marks civilized time.

--- Down here, each action requires 1 energy point. And without energy, your health will decrease 11 points per action. ---

You can see 'Basecamp Chest' (closed) here.

Load: 0%  Energy: 98%  Health: 100%

>l
Basecamp
Plaza Argentina Base Camp (4200m) for Mt. Aconcagua. The trail up to the summit begins here. It's a dangerous, but non-technical climb. There is a collection of ragtag temporary structures that form the Guardia's seasonal presence at the less popular Polish Route base camp. Brightly colored tents dot the plateau. The Polish Glacier looms in the distance, and a swift stream - the headwaters of the Vacas river flow from its base. There is an outhouse on the edge of camp. The weekly helicopter retrieval of the 50 gallon drum of waste is a highlight and one of the only things that marks civilized time.

--- Down here, each action requires 1 energy point. And without energy, your health will decrease 11 points per action. ---

You can see 'Basecamp Chest' (closed) here.

Load: 0%  Energy: 97%  Health: 100%

>l
Basecamp
Plaza Argentina Base Camp (4200m) for Mt. Aconcagua. The trail up to the summit begins here. It's a dangerous, but non-technical climb. There is a collection of ragtag temporary structures that form the Guardia's seasonal presence at the less popular Polish Route base camp. Brightly colored tents dot the plateau. The Polish Glacier looms in the distance, and a swift stream - the headwaters of the Vacas river flow from its base. There is an outhouse on the edge of camp. The weekly helicopter retrieval of the 50 gallon drum of waste is a highlight and one of the only things that marks civilized time.

--- Down here, each action requires 1 energy point. And without energy, your health will decrease 11 points per action. ---

You can see 'Basecamp Chest' (closed) here.

Load: 0%  Energy: 96%  Health: 100%

>ll
That's not a verb I recognise.

>l
Basecamp
Plaza Argentina Base Camp (4200m) for Mt. Aconcagua. The trail up to the summit begins here. It's a dangerous, but non-technical climb. There is a collection of ragtag temporary structures that form the Guardia's seasonal presence at the less popular Polish Route base camp. Brightly colored tents dot the plateau. The Polish Glacier looms in the distance, and a swift stream - the headwaters of the Vacas river flow from its base. There is an outhouse on the edge of camp. The weekly helicopter retrieval of the 50 gallon drum of waste is a highlight and one of the only things that marks civilized time.

--- Down here, each action requires 1 energy point. And without energy, your health will decrease 11 points per action. ---

You can see 'Basecamp Chest' (closed) here.

Load: 0%  Energy: 95%  Health: 100%

>l
Basecamp
Plaza Argentina Base Camp (4200m) for Mt. Aconcagua. The trail up to the summit begins here. It's a dangerous, but non-technical climb. There is a collection of ragtag temporary structures that form the Guardia's seasonal presence at the less popular Polish Route base camp. Brightly colored tents dot the plateau. The Polish Glacier looms in the distance, and a swift stream - the headwaters of the Vacas river flow from its base. There is an outhouse on the edge of camp. The weekly helicopter retrieval of the 50 gallon drum of waste is a highlight and one of the only things that marks civilized time.

--- Down here, each action requires 1 energy point. And without energy, your health will decrease 11 points per action. ---

You can see 'Basecamp Chest' (closed) here.

Load: 0%  Energy: 94%  Health: 100%

>l
Basecamp
Plaza Argentina Base Camp (4200m) for Mt. Aconcagua. The trail up to the summit begins here. It's a dangerous, but non-technical climb. There is a collection of ragtag temporary structures that form the Guardia's seasonal presence at the less popular Polish Route base camp. Brightly colored tents dot the plateau. The Polish Glacier looms in the distance, and a swift stream - the headwaters of the Vacas river flow from its base. There is an outhouse on the edge of camp. The weekly helicopter retrieval of the 50 gallon drum of waste is a highlight and one of the only things that marks civilized time.

--- Down here, each action requires 1 energy point. And without energy, your health will decrease 11 points per action. ---

You can see 'Basecamp Chest' (closed) here.

Load: 0%  Energy: 93%  Health: 100%

>l
Basecamp
Plaza Argentina Base Camp (4200m) for Mt. Aconcagua. The trail up to the summit begins here. It's a dangerous, but non-technical climb. There is a collection of ragtag temporary structures that form the Guardia's seasonal presence at the less popular Polish Route base camp. Brightly colored tents dot the plateau. The Polish Glacier looms in the distance, and a swift stream - the headwaters of the Vacas river flow from its base. There is an outhouse on the edge of camp. The weekly helicopter retrieval of the 50 gallon drum of waste is a highlight and one of the only things that marks civilized time.

--- Down here, each action requires 1 energy point. And without energy, your health will decrease 11 points per action. ---

You can see 'Basecamp Chest' (closed) here.

Load: 0%  Energy: 92%  Health: 100%

>l
Basecamp
Plaza Argentina Base Camp (4200m) for Mt. Aconcagua. The trail up to the summit begins here. It's a dangerous, but non-technical climb. There is a collection of ragtag temporary structures that form the Guardia's seasonal presence at the less popular Polish Route base camp. Brightly colored tents dot the plateau. The Polish Glacier looms in the distance, and a swift stream - the headwaters of the Vacas river flow from its base. There is an outhouse on the edge of camp. The weekly helicopter retrieval of the 50 gallon drum of waste is a highlight and one of the only things that marks civilized time.

--- Down here, each action requires 1 energy point. And without energy, your health will decrease 11 points per action. ---

You can see 'Basecamp Chest' (closed) here.

Load: 0%  Energy: 91%  Health: 100%

>l
Basecamp
Plaza Argentina Base Camp (4200m) for Mt. Aconcagua. The trail up to the summit begins here. It's a dangerous, but non-technical climb. There is a collection of ragtag temporary structures that form the Guardia's seasonal presence at the less popular Polish Route base camp. Brightly colored tents dot the plateau. The Polish Glacier looms in the distance, and a swift stream - the headwaters of the Vacas river flow from its base. There is an outhouse on the edge of camp. The weekly helicopter retrieval of the 50 gallon drum of waste is a highlight and one of the only things that marks civilized time.

--- Down here, each action requires 1 energy point. And without energy, your health will decrease 11 points per action. ---

You can see 'Basecamp Chest' (closed) here.

Load: 0%  Energy: 90%  Health: 100%

>l
Basecamp
Plaza Argentina Base Camp (4200m) for Mt. Aconcagua. The trail up to the summit begins here. It's a dangerous, but non-technical climb. There is a collection of ragtag temporary structures that form the Guardia's seasonal presence at the less popular Polish Route base camp. Brightly colored tents dot the plateau. The Polish Glacier looms in the distance, and a swift stream - the headwaters of the Vacas river flow from its base. There is an outhouse on the edge of camp. The weekly helicopter retrieval of the 50 gallon drum of waste is a highlight and one of the only things that marks civilized time.

--- Down here, each action requires 1 energy point. And without energy, your health will decrease 11 points per action. ---

You can see 'Basecamp Chest' (closed) here.

Load: 0%  Energy: 89%  Health: 100%

>l
Basecamp
Plaza Argentina Base Camp (4200m) for Mt. Aconcagua. The trail up to the summit begins here. It's a dangerous, but non-technical climb. There is a collection of ragtag temporary structures that form the Guardia's seasonal presence at the less popular Polish Route base camp. Brightly colored tents dot the plateau. The Polish Glacier looms in the distance, and a swift stream - the headwaters of the Vacas river flow from its base. There is an outhouse on the edge of camp. The weekly helicopter retrieval of the 50 gallon drum of waste is a highlight and one of the only things that marks civilized time.

--- Down here, each action requires 1 energy point. And without energy, your health will decrease 11 points per action. ---

You can see 'Basecamp Chest' (closed) here.

Load: 0%  Energy: 88%  Health: 100%

>l
Basecamp
Plaza Argentina Base Camp (4200m) for Mt. Aconcagua. The trail up to the summit begins here. It's a dangerous, but non-technical climb. There is a collection of ragtag temporary structures that form the Guardia's seasonal presence at the less popular Polish Route base camp. Brightly colored tents dot the plateau. The Polish Glacier looms in the distance, and a swift stream - the headwaters of the Vacas river flow from its base. There is an outhouse on the edge of camp. The weekly helicopter retrieval of the 50 gallon drum of waste is a highlight and one of the only things that marks civilized time.

--- Down here, each action requires 1 energy point. And without energy, your health will decrease 11 points per action. ---

You can see 'Basecamp Chest' (closed) here.

Load: 0%  Energy: 87%  Health: 100%

>l
Basecamp
Plaza Argentina Base Camp (4200m) for Mt. Aconcagua. The trail up to the summit begins here. It's a dangerous, but non-technical climb. There is a collection of ragtag temporary structures that form the Guardia's seasonal presence at the less popular Polish Route base camp. Brightly colored tents dot the plateau. The Polish Glacier looms in the distance, and a swift stream - the headwaters of the Vacas river flow from its base. There is an outhouse on the edge of camp. The weekly helicopter retrieval of the 50 gallon drum of waste is a highlight and one of the only things that marks civilized time.

--- Down here, each action requires 1 energy point. And without energy, your health will decrease 11 points per action. ---

You can see 'Basecamp Chest' (closed) here.

Load: 0%  Energy: 86%  Health: 100%

>l
Basecamp
Plaza Argentina Base Camp (4200m) for Mt. Aconcagua. The trail up to the summit begins here. It's a dangerous, but non-technical climb. There is a collection of ragtag temporary structures that form the Guardia's seasonal presence at the less popular Polish Route base camp. Brightly colored tents dot the plateau. The Polish Glacier looms in the distance, and a swift stream - the headwaters of the Vacas river flow from its base. There is an outhouse on the edge of camp. The weekly helicopter retrieval of the 50 gallon drum of waste is a highlight and one of the only things that marks civilized time.

--- Down here, each action requires 1 energy point. And without energy, your health will decrease 11 points per action. ---

You can see 'Basecamp Chest' (closed) here.

Load: 0%  Energy: 85%  Health: 100%

>l
Basecamp
Plaza Argentina Base Camp (4200m) for Mt. Aconcagua. The trail up to the summit begins here. It's a dangerous, but non-technical climb. There is a collection of ragtag temporary structures that form the Guardia's seasonal presence at the less popular Polish Route base camp. Brightly colored tents dot the plateau. The Polish Glacier looms in the distance, and a swift stream - the headwaters of the Vacas river flow from its base. There is an outhouse on the edge of camp. The weekly helicopter retrieval of the 50 gallon drum of waste is a highlight and one of the only things that marks civilized time.

--- Down here, each action requires 1 energy point. And without energy, your health will decrease 11 points per action. ---

You can see 'Basecamp Chest' (closed) here.

Load: 0%  Energy: 84%  Health: 100%

>l
Basecamp
Plaza Argentina Base Camp (4200m) for Mt. Aconcagua. The trail up to the summit begins here. It's a dangerous, but non-technical climb. There is a collection of ragtag temporary structures that form the Guardia's seasonal presence at the less popular Polish Route base camp. Brightly colored tents dot the plateau. The Polish Glacier looms in the distance, and a swift stream - the headwaters of the Vacas river flow from its base. There is an outhouse on the edge of camp. The weekly helicopter retrieval of the 50 gallon drum of waste is a highlight and one of the only things that marks civilized time.

--- Down here, each action requires 1 energy point. And without energy, your health will decrease 11 points per action. ---

You can see 'Basecamp Chest' (closed) here.

Load: 0%  Energy: 83%  Health: 100%

>l
Basecamp
Plaza Argentina Base Camp (4200m) for Mt. Aconcagua. The trail up to the summit begins here. It's a dangerous, but non-technical climb. There is a collection of ragtag temporary structures that form the Guardia's seasonal presence at the less popular Polish Route base camp. Brightly colored tents dot the plateau. The Polish Glacier looms in the distance, and a swift stream - the headwaters of the Vacas river flow from its base. There is an outhouse on the edge of camp. The weekly helicopter retrieval of the 50 gallon drum of waste is a highlight and one of the only things that marks civilized time.

--- Down here, each action requires 1 energy point. And without energy, your health will decrease 11 points per action. ---

You can see 'Basecamp Chest' (closed) here.

Load: 0%  Energy: 82%  Health: 100%

>l
Basecamp
Plaza Argentina Base Camp (4200m) for Mt. Aconcagua. The trail up to the summit begins here. It's a dangerous, but non-technical climb. There is a collection of ragtag temporary structures that form the Guardia's seasonal presence at the less popular Polish Route base camp. Brightly colored tents dot the plateau. The Polish Glacier looms in the distance, and a swift stream - the headwaters of the Vacas river flow from its base. There is an outhouse on the edge of camp. The weekly helicopter retrieval of the 50 gallon drum of waste is a highlight and one of the only things that marks civilized time.

--- Down here, each action requires 1 energy point. And without energy, your health will decrease 11 points per action. ---

You can see 'Basecamp Chest' (closed) here.

Load: 0%  Energy: 81%  Health: 100%

>l
Basecamp
Plaza Argentina Base Camp (4200m) for Mt. Aconcagua. The trail up to the summit begins here. It's a dangerous, but non-technical climb. There is a collection of ragtag temporary structures that form the Guardia's seasonal presence at the less popular Polish Route base camp. Brightly colored tents dot the plateau. The Polish Glacier looms in the distance, and a swift stream - the headwaters of the Vacas river flow from its base. There is an outhouse on the edge of camp. The weekly helicopter retrieval of the 50 gallon drum of waste is a highlight and one of the only things that marks civilized time.

--- Down here, each action requires 1 energy point. And without energy, your health will decrease 11 points per action. ---

You can see 'Basecamp Chest' (closed) here.

Load: 0%  Energy: 80%  Health: 100%

>l
Basecamp
Plaza Argentina Base Camp (4200m) for Mt. Aconcagua. The trail up to the summit begins here. It's a dangerous, but non-technical climb. There is a collection of ragtag temporary structures that form the Guardia's seasonal presence at the less popular Polish Route base camp. Brightly colored tents dot the plateau. The Polish Glacier looms in the distance, and a swift stream - the headwaters of the Vacas river flow from its base. There is an outhouse on the edge of camp. The weekly helicopter retrieval of the 50 gallon drum of waste is a highlight and one of the only things that marks civilized time.

--- Down here, each action requires 1 energy point. And without energy, your health will decrease 11 points per action. ---

You can see 'Basecamp Chest' (closed) here.

Load: 0%  Energy: 79%  Health: 100%

>l
Basecamp
Plaza Argentina Base Camp (4200m) for Mt. Aconcagua. The trail up to the summit begins here. It's a dangerous, but non-technical climb. There is a collection of ragtag temporary structures that form the Guardia's seasonal presence at the less popular Polish Route base camp. Brightly colored tents dot the plateau. The Polish Glacier looms in the distance, and a swift stream - the headwaters of the Vacas river flow from its base. There is an outhouse on the edge of camp. The weekly helicopter retrieval of the 50 gallon drum of waste is a highlight and one of the only things that marks civilized time.

--- Down here, each action requires 1 energy point. And without energy, your health will decrease 11 points per action. ---

You can see 'Basecamp Chest' (closed) here.

Load: 0%  Energy: 78%  Health: 100%

>open chest
You open 'Basecamp Chest', revealing a water bottle, an ice axe, a tent and an orange.

Load: 0%  Energy: 77%  Health: 100%

>take water
Taken.

Load: 0%  Energy: 76%  Health: 100%

>drink water
Aaaaahh! Very refreshing.

Load: 0%  Energy: 85%  Health: 100%

* * *

>look
Basecamp
Plaza Argentina Base Camp (4200m) for Mt. Aconcagua. The trail up to the summit begins here. It's a dangerous, but non-technical climb. There is a collection of ragtag temporary structures that form the Guardia's seasonal presence at the less popular Polish Route base camp. Brightly colored tents dot the plateau. The Polish Glacier looms in the distance, and a swift stream - the headwaters of the Vacas river flow from its base. There is an outhouse on the edge of camp. The weekly helicopter retrieval of the 50 gallon drum of waste is a highlight and one of the only things that marks civilized time.

--- Down here, each action requires 1 energy point. And without energy, your health will decrease 11 points per action. ---

You can see 'Basecamp Chest' (closed) here.

Use your map to help you decide what supplies you should take on your ascent.
Current Load: 0%    Max Load: 100%            Energy: 99%    Health: 100%

>go north
Before heading up to Camp1, you should at least bring food, water, shelter, and an ice axe.

Load: 0%  Energy: 98%  Health: 100%

* * *

>look
Basecamp
Plaza Argentina Base Camp (4200m) for Mt. Aconcagua. The trail up to the summit begins here. It's a dangerous, but non-technical climb. There is a collection of ragtag temporary structures that form the Guardia's seasonal presence at the less popular Polish Route base camp. Brightly colored tents dot the plateau. The Polish Glacier looms in the distance, and a swift stream - the headwaters of the Vacas river flow from its base. There is an outhouse on the edge of camp. The weekly helicopter retrieval of the 50 gallon drum of waste is a highlight and one of the only things that marks civilized time.

--- Here, each action requires 15 energy point. And without energy, your health will decrease 11 points per action. ---

You can see 'Basecamp Chest' (closed) here.

Energy: 70%  Health: 100%

>go north
Camp1
Camp 1 (4900m)  At 16,076 feet above sea level, Camp 1 is higher than most people have every climbed. It is higher than any peak in North America. It is just 1000 feet lower than Everest Base Camp in Nepal. Camp 1 is located at the top of the trail on a plateau. Aconcagua is not visible from here, but its sister, Mt. Ameguino's snowy peak looms above you. The camp is located several hundred meters from the glacial stream. There is no outhouse (you must bury your waste, away from any area that could contaminate the stream). Carrying water from the stream to boil for hydration and cooking is required. You can only carry part of what you need to Camp 1 on your first trip, so you must plan carefully. Climbers stay one night in Camp 1, then return to Base Camp for more supplies. You have to bring the bare essentials - tent, sleeping bag, camp stove, food. You don't immediately need ice climbing equipment - mountaineering boots, crampons, ice ax, harness, helmet, rope. But you will eventually need to bring up to Camp 1, as it's needed at higher elevations.

--- Here, each action requires 2 energy points. And without energy, your health will decrease 12 points per action. ---

Energy: 96%  Health: 100%

>look
Camp1
Camp 1 (4900m)  At 16,076 feet above sea level, Camp 1 is higher than most people have every climbed. It is higher than any peak in North America. It is just 1000 feet lower than Everest Base Camp in Nepal. Camp 1 is located at the top of the trail on a plateau. Aconcagua is not visible from here, but its sister, Mt. Ameguino's snowy peak looms above you. The camp is located several hundred meters from the glacial stream. There is no outhouse (you must bury your waste, away from any area that could contaminate the stream). Carrying water from the stream to boil for hydration and cooking is required. You can only carry part of what you need to Camp 1 on your first trip, so you must plan carefully. Climbers stay one night in Camp 1, then return to Base Camp for more supplies. You have to bring the bare essentials - tent, sleeping bag, camp stove, food. You don't immediately need ice climbing equipment - mountaineering boots, crampons, ice ax, harness, helmet, rope. But you will eventually need to bring up to Camp 1, as it's needed at higher elevations.

--- Here, each action requires 2 energy points. And without energy, your health will decrease 12 points per action. ---

Energy: 94%  Health: 100%

>look
Camp1
Camp 1 (4900m)  At 16,076 feet above sea level, Camp 1 is higher than most people have every climbed. It is higher than any peak in North America. It is just 1000 feet lower than Everest Base Camp in Nepal. Camp 1 is located at the top of the trail on a plateau. Aconcagua is not visible from here, but its sister, Mt. Ameguino's snowy peak looms above you. The camp is located several hundred meters from the glacial stream. There is no outhouse (you must bury your waste, away from any area that could contaminate the stream). Carrying water from the stream to boil for hydration and cooking is required. You can only carry part of what you need to Camp 1 on your first trip, so you must plan carefully. Climbers stay one night in Camp 1, then return to Base Camp for more supplies. You have to bring the bare essentials - tent, sleeping bag, camp stove, food. You don't immediately need ice climbing equipment - mountaineering boots, crampons, ice ax, harness, helmet, rope. But you will eventually need to bring up to Camp 1, as it's needed at higher elevations.

--- Here, each action requires 2 energy points. And without energy, your health will decrease 12 points per action. ---

Energy: 92%  Health: 100%

>go north
Camp2
Camp 2 (5850m) Camp 2 is located at the base of visible portions of the Polish Glacier. Below, it retreats under the moraine, but above you, it appears as a both a wall and a river of blue-green ice and white pillars. These are Los Penitentes, statues in ice guarding the glacier. From here, you can see all the way to the Valle de Vacas. Just like with portages from Plaza Argentina to Camp 1, you must make several trips over 3 days from Camp 1 to Camp 2 to haul the rest of your gear. You leave almost nothing behind at Camp 1, except for an emergency shelter tent and some provisions. You have the option of stashing extra water and saving some of your favorite food for the descent.

--- Here, each action requires 5 energy points. And without energy, your health will decrease 15 points per action. ---

Energy: 87%  Health: 100%

>look
Camp2
Camp 2 (5850m) Camp 2 is located at the base of visible portions of the Polish Glacier. Below, it retreats under the moraine, but above you, it appears as a both a wall and a river of blue-green ice and white pillars. These are Los Penitentes, statues in ice guarding the glacier. From here, you can see all the way to the Valle de Vacas. Just like with portages from Plaza Argentina to Camp 1, you must make several trips over 3 days from Camp 1 to Camp 2 to haul the rest of your gear. You leave almost nothing behind at Camp 1, except for an emergency shelter tent and some provisions. You have the option of stashing extra water and saving some of your favorite food for the descent.

--- Here, each action requires 5 energy points. And without energy, your health will decrease 15 points per action. ---

Energy: 82%  Health: 100%

>look
Camp2
Camp 2 (5850m) Camp 2 is located at the base of visible portions of the Polish Glacier. Below, it retreats under the moraine, but above you, it appears as a both a wall and a river of blue-green ice and white pillars. These are Los Penitentes, statues in ice guarding the glacier. From here, you can see all the way to the Valle de Vacas. Just like with portages from Plaza Argentina to Camp 1, you must make several trips over 3 days from Camp 1 to Camp 2 to haul the rest of your gear. You leave almost nothing behind at Camp 1, except for an emergency shelter tent and some provisions. You have the option of stashing extra water and saving some of your favorite food for the descent.

--- Here, each action requires 5 energy points. And without energy, your health will decrease 15 points per action. ---

Energy: 77%  Health: 100%

>go north
Camp3
Camp 3 (400m elevation gain). No one stays in Camp 3 for long. It is above the "kill zone" where lack of oxygen and hypoxia can cause rapid deterioration in your mental and physical state. If you decide to use Camp 3, it's only for a quick stop over so you can be up well before sunrise to attempt the summit. You take only the bare essentials: shelter, food, safety equipment, and your climbing gear. You leave your tent and sleeping bag behind, but you won't be staying at Camp 3 after the summit. You will stop to retrieve your equipment, if you survive the summit, but that's it. If you choose to summit from Camp 3, you will have less climbing to do, but you will also be weaker from the extra time at altitude.

--- Here, each action requires 10 energy points. And without energy, your health will decrease 20 points per action. ---

Energy: 67%  Health: 100%

>look
Camp3
Camp 3 (400m elevation gain). No one stays in Camp 3 for long. It is above the "kill zone" where lack of oxygen and hypoxia can cause rapid deterioration in your mental and physical state. If you decide to use Camp 3, it's only for a quick stop over so you can be up well before sunrise to attempt the summit. You take only the bare essentials: shelter, food, safety equipment, and your climbing gear. You leave your tent and sleeping bag behind, but you won't be staying at Camp 3 after the summit. You will stop to retrieve your equipment, if you survive the summit, but that's it. If you choose to summit from Camp 3, you will have less climbing to do, but you will also be weaker from the extra time at altitude.

--- Here, each action requires 10 energy points. And without energy, your health will decrease 20 points per action. ---

Energy: 57%  Health: 100%

>look
Camp3
Camp 3 (400m elevation gain). No one stays in Camp 3 for long. It is above the "kill zone" where lack of oxygen and hypoxia can cause rapid deterioration in your mental and physical state. If you decide to use Camp 3, it's only for a quick stop over so you can be up well before sunrise to attempt the summit. You take only the bare essentials: shelter, food, safety equipment, and your climbing gear. You leave your tent and sleeping bag behind, but you won't be staying at Camp 3 after the summit. You will stop to retrieve your equipment, if you survive the summit, but that's it. If you choose to summit from Camp 3, you will have less climbing to do, but you will also be weaker from the extra time at altitude.

--- Here, each action requires 10 energy points. And without energy, your health will decrease 20 points per action. ---

Energy: 47%  Health: 100%

>go north
Summit
Summit (6962m). The summit of Aconcagua is unremarkable in some ways. It's a rocky outcropping with various markers, cairns and flags placed there by other climbers. You pause, but not for too long, for photographs and to congratulate members of your team for the accomplishment. You know that you are on the highest peak anywhere except for the Himalayas. Now, you must descend before the weather turns or you lose your mind from lack of oxygen.

--- Here, each action requires 10 energy points. And without energy, your health will decrease 20 points per action. ---

Energy: 37%  Health: 100%

>look
Summit
Summit (6962m). The summit of Aconcagua is unremarkable in some ways. It's a rocky outcropping with various markers, cairns and flags placed there by other climbers. You pause, but not for too long, for photographs and to congratulate members of your team for the accomplishment. You know that you are on the highest peak anywhere except for the Himalayas. Now, you must descend before the weather turns or you lose your mind from lack of oxygen.

--- Here, each action requires 10 energy points. And without energy, your health will decrease 20 points per action. ---

Energy: 27%  Health: 100%

>look
Summit
Summit (6962m). The summit of Aconcagua is unremarkable in some ways. It's a rocky outcropping with various markers, cairns and flags placed there by other climbers. You pause, but not for too long, for photographs and to congratulate members of your team for the accomplishment. You know that you are on the highest peak anywhere except for the Himalayas. Now, you must descend before the weather turns or you lose your mind from lack of oxygen.

--- Here, each action requires 10 energy points. And without energy, your health will decrease 20 points per action. ---

Energy: 17%  Health: 100%

>look
Summit
Summit (6962m). The summit of Aconcagua is unremarkable in some ways. It's a rocky outcropping with various markers, cairns and flags placed there by other climbers. You pause, but not for too long, for photographs and to congratulate members of your team for the accomplishment. You know that you are on the highest peak anywhere except for the Himalayas. Now, you must descend before the weather turns or you lose your mind from lack of oxygen.

--- Here, each action requires 10 energy points. And without energy, your health will decrease 20 points per action. ---

Energy: 7%  Health: 100%

>look
Summit
Summit (6962m). The summit of Aconcagua is unremarkable in some ways. It's a rocky outcropping with various markers, cairns and flags placed there by other climbers. You pause, but not for too long, for photographs and to congratulate members of your team for the accomplishment. You know that you are on the highest peak anywhere except for the Himalayas. Now, you must descend before the weather turns or you lose your mind from lack of oxygen.

--- Here, each action requires 10 energy points. And without energy, your health will decrease 20 points per action. ---

Energy: 0%  Health: 80%

>look
Summit
Summit (6962m). The summit of Aconcagua is unremarkable in some ways. It's a rocky outcropping with various markers, cairns and flags placed there by other climbers. You pause, but not for too long, for photographs and to congratulate members of your team for the accomplishment. You know that you are on the highest peak anywhere except for the Himalayas. Now, you must descend before the weather turns or you lose your mind from lack of oxygen.

--- Here, each action requires 10 energy points. And without energy, your health will decrease 20 points per action. ---

Energy: 0%  Health: 60%

>look
Summit
Summit (6962m). The summit of Aconcagua is unremarkable in some ways. It's a rocky outcropping with various markers, cairns and flags placed there by other climbers. You pause, but not for too long, for photographs and to congratulate members of your team for the accomplishment. You know that you are on the highest peak anywhere except for the Himalayas. Now, you must descend before the weather turns or you lose your mind from lack of oxygen.

--- Here, each action requires 10 energy points. And without energy, your health will decrease 20 points per action. ---

Energy: 0%  Health: 40%

>look
Summit
Summit (6962m). The summit of Aconcagua is unremarkable in some ways. It's a rocky outcropping with various markers, cairns and flags placed there by other climbers. You pause, but not for too long, for photographs and to congratulate members of your team for the accomplishment. You know that you are on the highest peak anywhere except for the Himalayas. Now, you must descend before the weather turns or you lose your mind from lack of oxygen.

--- Here, each action requires 10 energy points. And without energy, your health will decrease 20 points per action. ---

Energy: 0%  Health: 20%

>look
Summit
Summit (6962m). The summit of Aconcagua is unremarkable in some ways. It's a rocky outcropping with various markers, cairns and flags placed there by other climbers. You pause, but not for too long, for photographs and to congratulate members of your team for the accomplishment. You know that you are on the highest peak anywhere except for the Himalayas. Now, you must descend before the weather turns or you lose your mind from lack of oxygen.

--- Here, each action requires 10 energy points. And without energy, your health will decrease 20 points per action. ---

Energy: 0%  Health: 20%

    *** You have died :( ***

Would you like to RESTART, RESTORE a saved game, QUIT or UNDO the last command?

* * *

>look
Basecamp
Plaza Argentina Base Camp (4200m) for Mt. Aconcagua. The trail up to the summit begins here. It's a dangerous, but non-technical climb. There is a collection of ragtag temporary structures that form the Guardia's seasonal presence at the less popular Polish Route base camp. Brightly colored tents dot the plateau. The Polish Glacier looms in the distance, and a swift stream - the headwaters of the Vacas river flow from its base. There is an outhouse on the edge of camp. The weekly helicopter retrieval of the 50 gallon drum of waste is a highlight and one of the only things that marks civilized time.

--- Here, each action requires 15 energy point. And without energy, your health will decrease 11 points per action. ---

You can see 'Basecamp Chest' (closed) here.

Energy: 55%  Health: 100%

>go to camp1
Are you sure you want to go to Camp1?

>yes
You walk to Camp1.

Camp1
Camp 1 (4900m)  At 16,076 feet above sea level, Camp 1 is higher than most people have every climbed. It is higher than any peak in North America. It is just 1000 feet lower than Everest Base Camp in Nepal. Camp 1 is located at the top of the trail on a plateau. Aconcagua is not visible from here, but its sister, Mt. Ameguino's snowy peak looms above you. The camp is located several hundred meters from the glacial stream. There is no outhouse (you must bury your waste, away from any area that could contaminate the stream). Carrying water from the stream to boil for hydration and cooking is required. You can only carry part of what you need to Camp 1 on your first trip, so you must plan carefully. Climbers stay one night in Camp 1, then return to Base Camp for more supplies. You have to bring the bare essentials - tent, sleeping bag, camp stove, food. You don't immediately need ice climbing equipment - mountaineering boots, crampons, ice ax, harness, helmet, rope. But you will eventually need to bring up to Camp 1, as it's needed at higher elevations.

--- Here, each action requires 2 energy points. And without energy, your health will decrease 12 points per action. ---

Energy: 95%  Health: 100%

* * *

>lokk
That's not a verb I recognise.

>look
Basecamp
Plaza Argentina Base Camp (4200m) for Mt. Aconcagua. The trail up to the summit begins here. It's a dangerous, but non-technical climb. There is a collection of ragtag temporary structures that form the Guardia's seasonal presence at the less popular Polish Route base camp. Brightly colored tents dot the plateau. The Polish Glacier looms in the distance, and a swift stream - the headwaters of the Vacas river flow from its base. There is an outhouse on the edge of camp. The weekly helicopter retrieval of the 50 gallon drum of waste is a highlight and one of the only things that marks civilized time.

--- Here, each action requires 15 energy point. And without energy, your health will decrease 11 points per action. ---

You can see 'Basecamp Chest' (closed) here.

Energy: 40%  Health: 100%

>look
Basecamp
Plaza Argentina Base Camp (4200m) for Mt. Aconcagua. The trail up to the summit begins here. It's a dangerous, but non-technical climb. There is a collection of ragtag temporary structures that form the Guardia's seasonal presence at the less popular Polish Route base camp. Brightly colored tents dot the plateau. The Polish Glacier looms in the distance, and a swift stream - the headwaters of the Vacas river flow from its base. There is an outhouse on the edge of camp. The weekly helicopter retrieval of the 50 gallon drum of waste is a highlight and one of the only things that marks civilized time.

--- Here, each action requires 15 energy point. And without energy, your health will decrease 11 points per action. ---

You can see 'Basecamp Chest' (closed) here.

Energy: 25%  Health: 100%

>look
Basecamp
Plaza Argentina Base Camp (4200m) for Mt. Aconcagua. The trail up to the summit begins here. It's a dangerous, but non-technical climb. There is a collection of ragtag temporary structures that form the Guardia's seasonal presence at the less popular Polish Route base camp. Brightly colored tents dot the plateau. The Polish Glacier looms in the distance, and a swift stream - the headwaters of the Vacas river flow from its base. There is an outhouse on the edge of camp. The weekly helicopter retrieval of the 50 gallon drum of waste is a highlight and one of the only things that marks civilized time.

--- Here, each action requires 15 energy point. And without energy, your health will decrease 11 points per action. ---

You can see 'Basecamp Chest' (closed) here.

Energy: 10%  Health: 100%

>look
Basecamp
Plaza Argentina Base Camp (4200m) for Mt. Aconcagua. The trail up to the summit begins here. It's a dangerous, but non-technical climb. There is a collection of ragtag temporary structures that form the Guardia's seasonal presence at the less popular Polish Route base camp. Brightly colored tents dot the plateau. The Polish Glacier looms in the distance, and a swift stream - the headwaters of the Vacas river flow from its base. There is an outhouse on the edge of camp. The weekly helicopter retrieval of the 50 gallon drum of waste is a highlight and one of the only things that marks civilized time.

--- Here, each action requires 15 energy point. And without energy, your health will decrease 11 points per action. ---

You can see 'Basecamp Chest' (closed) here.

Energy: 0%  Health: 89%

>look
Basecamp
Plaza Argentina Base Camp (4200m) for Mt. Aconcagua. The trail up to the summit begins here. It's a dangerous, but non-technical climb. There is a collection of ragtag temporary structures that form the Guardia's seasonal presence at the less popular Polish Route base camp. Brightly colored tents dot the plateau. The Polish Glacier looms in the distance, and a swift stream - the headwaters of the Vacas river flow from its base. There is an outhouse on the edge of camp. The weekly helicopter retrieval of the 50 gallon drum of waste is a highlight and one of the only things that marks civilized time.

--- Here, each action requires 15 energy point. And without energy, your health will decrease 11 points per action. ---

You can see 'Basecamp Chest' (closed) here.

Energy: 0%  Health: 78%

>look
Basecamp
Plaza Argentina Base Camp (4200m) for Mt. Aconcagua. The trail up to the summit begins here. It's a dangerous, but non-technical climb. There is a collection of ragtag temporary structures that form the Guardia's seasonal presence at the less popular Polish Route base camp. Brightly colored tents dot the plateau. The Polish Glacier looms in the distance, and a swift stream - the headwaters of the Vacas river flow from its base. There is an outhouse on the edge of camp. The weekly helicopter retrieval of the 50 gallon drum of waste is a highlight and one of the only things that marks civilized time.

--- Here, each action requires 15 energy point. And without energy, your health will decrease 11 points per action. ---

You can see 'Basecamp Chest' (closed) here.

Energy: 0%  Health: 67%

>look
Basecamp
Plaza Argentina Base Camp (4200m) for Mt. Aconcagua. The trail up to the summit begins here. It's a dangerous, but non-technical climb. There is a collection of ragtag temporary structures that form the Guardia's seasonal presence at the less popular Polish Route base camp. Brightly colored tents dot the plateau. The Polish Glacier looms in the distance, and a swift stream - the headwaters of the Vacas river flow from its base. There is an outhouse on the edge of camp. The weekly helicopter retrieval of the 50 gallon drum of waste is a highlight and one of the only things that marks civilized time.

--- Here, each action requires 15 energy point. And without energy, your health will decrease 11 points per action. ---

You can see 'Basecamp Chest' (closed) here.

Energy: 0%  Health: 56%

>look
Basecamp
Plaza Argentina Base Camp (4200m) for Mt. Aconcagua. The trail up to the summit begins here. It's a dangerous, but non-technical climb. There is a collection of ragtag temporary structures that form the Guardia's seasonal presence at the less popular Polish Route base camp. Brightly colored tents dot the plateau. The Polish Glacier looms in the distance, and a swift stream - the headwaters of the Vacas river flow from its base. There is an outhouse on the edge of camp. The weekly helicopter retrieval of the 50 gallon drum of waste is a highlight and one of the only things that marks civilized time.

--- Here, each action requires 15 energy point. And without energy, your health will decrease 11 points per action. ---

You can see 'Basecamp Chest' (closed) here.

Energy: 0%  Health: 45%

>look
Basecamp
Plaza Argentina Base Camp (4200m) for Mt. Aconcagua. The trail up to the summit begins here. It's a dangerous, but non-technical climb. There is a collection of ragtag temporary structures that form the Guardia's seasonal presence at the less popular Polish Route base camp. Brightly colored tents dot the plateau. The Polish Glacier looms in the distance, and a swift stream - the headwaters of the Vacas river flow from its base. There is an outhouse on the edge of camp. The weekly helicopter retrieval of the 50 gallon drum of waste is a highlight and one of the only things that marks civilized time.

--- Here, each action requires 15 energy point. And without energy, your health will decrease 11 points per action. ---

You can see 'Basecamp Chest' (closed) here.

Energy: 0%  Health: 34%

>look
Basecamp
Plaza Argentina Base Camp (4200m) for Mt. Aconcagua. The trail up to the summit begins here. It's a dangerous, but non-technical climb. There is a collection of ragtag temporary structures that form the Guardia's seasonal presence at the less popular Polish Route base camp. Brightly colored tents dot the plateau. The Polish Glacier looms in the distance, and a swift stream - the headwaters of the Vacas river flow from its base. There is an outhouse on the edge of camp. The weekly helicopter retrieval of the 50 gallon drum of waste is a highlight and one of the only things that marks civilized time.

--- Here, each action requires 15 energy point. And without energy, your health will decrease 11 points per action. ---

You can see 'Basecamp Chest' (closed) here.

Energy: 0%  Health: 23%

>look
Basecamp
Plaza Argentina Base Camp (4200m) for Mt. Aconcagua. The trail up to the summit begins here. It's a dangerous, but non-technical climb. There is a collection of ragtag temporary structures that form the Guardia's seasonal presence at the less popular Polish Route base camp. Brightly colored tents dot the plateau. The Polish Glacier looms in the distance, and a swift stream - the headwaters of the Vacas river flow from its base. There is an outhouse on the edge of camp. The weekly helicopter retrieval of the 50 gallon drum of waste is a highlight and one of the only things that marks civilized time.

--- Here, each action requires 15 energy point. And without energy, your health will decrease 11 points per action. ---

You can see 'Basecamp Chest' (closed) here.

Energy: 0%  Health: 12%

>look
Basecamp
Plaza Argentina Base Camp (4200m) for Mt. Aconcagua. The trail up to the summit begins here. It's a dangerous, but non-technical climb. There is a collection of ragtag temporary structures that form the Guardia's seasonal presence at the less popular Polish Route base camp. Brightly colored tents dot the plateau. The Polish Glacier looms in the distance, and a swift stream - the headwaters of the Vacas river flow from its base. There is an outhouse on the edge of camp. The weekly helicopter retrieval of the 50 gallon drum of waste is a highlight and one of the only things that marks civilized time.

--- Here, each action requires 15 energy point. And without energy, your health will decrease 11 points per action. ---

You can see 'Basecamp Chest' (closed) here.

Energy: 0%  Health: 1%

>look
Basecamp
Plaza Argentina Base Camp (4200m) for Mt. Aconcagua. The trail up to the summit begins here. It's a dangerous, but non-technical climb. There is a collection of ragtag temporary structures that form the Guardia's seasonal presence at the less popular Polish Route base camp. Brightly colored tents dot the plateau. The Polish Glacier looms in the distance, and a swift stream - the headwaters of the Vacas river flow from its base. There is an outhouse on the edge of camp. The weekly helicopter retrieval of the 50 gallon drum of waste is a highlight and one of the only things that marks civilized time.

--- Here, each action requires 15 energy point. And without energy, your health will decrease 11 points per action. ---

You can see 'Basecamp Chest' (closed) here.

Energy: 0%  Health: 0%Energy: 0%  Health: 0%

    *** You have died :( ***

Would you like to RESTART, RESTORE a saved game, QUIT or UNDO the last command?

* * *

>look
Basecamp
Plaza Argentina Base Camp (4200m) for Mt. Aconcagua. The trail up to the summit begins here. It's a dangerous, but non-technical climb. There is a collection of ragtag temporary structures that form the Guardia's seasonal presence at the less popular Polish Route base camp. Brightly colored tents dot the plateau. The Polish Glacier looms in the distance, and a swift stream - the headwaters of the Vacas river flow from its base. There is an outhouse on the edge of camp. The weekly helicopter retrieval of the 50 gallon drum of waste is a highlight and one of the only things that marks civilized time.

--- Here, each action requires 1 energy point. And without energy, your health will decrease 11 points per action. ---

You can see 'Basecamp Chest' (closed) here.

Energy: 96%  Health: 100%

>look
Basecamp
Plaza Argentina Base Camp (4200m) for Mt. Aconcagua. The trail up to the summit begins here. It's a dangerous, but non-technical climb. There is a collection of ragtag temporary structures that form the Guardia's seasonal presence at the less popular Polish Route base camp. Brightly colored tents dot the plateau. The Polish Glacier looms in the distance, and a swift stream - the headwaters of the Vacas river flow from its base. There is an outhouse on the edge of camp. The weekly helicopter retrieval of the 50 gallon drum of waste is a highlight and one of the only things that marks civilized time.

--- Here, each action requires 1 energy point. And without energy, your health will decrease 11 points per action. ---

You can see 'Basecamp Chest' (closed) here.

Energy: 95%  Health: 100%

>look
Basecamp
Plaza Argentina Base Camp (4200m) for Mt. Aconcagua. The trail up to the summit begins here. It's a dangerous, but non-technical climb. There is a collection of ragtag temporary structures that form the Guardia's seasonal presence at the less popular Polish Route base camp. Brightly colored tents dot the plateau. The Polish Glacier looms in the distance, and a swift stream - the headwaters of the Vacas river flow from its base. There is an outhouse on the edge of camp. The weekly helicopter retrieval of the 50 gallon drum of waste is a highlight and one of the only things that marks civilized time.

--- Here, each action requires 1 energy point. And without energy, your health will decrease 11 points per action. ---

You can see 'Basecamp Chest' (closed) here.

Energy: 94%  Health: 100%

>lookl
That's not a verb I recognise.

>look
Basecamp
Plaza Argentina Base Camp (4200m) for Mt. Aconcagua. The trail up to the summit begins here. It's a dangerous, but non-technical climb. There is a collection of ragtag temporary structures that form the Guardia's seasonal presence at the less popular Polish Route base camp. Brightly colored tents dot the plateau. The Polish Glacier looms in the distance, and a swift stream - the headwaters of the Vacas river flow from its base. There is an outhouse on the edge of camp. The weekly helicopter retrieval of the 50 gallon drum of waste is a highlight and one of the only things that marks civilized time.

--- Here, each action requires 1 energy point. And without energy, your health will decrease 11 points per action. ---

You can see 'Basecamp Chest' (closed) here.

Energy: 93%  Health: 100%

>look
Basecamp
Plaza Argentina Base Camp (4200m) for Mt. Aconcagua. The trail up to the summit begins here. It's a dangerous, but non-technical climb. There is a collection of ragtag temporary structures that form the Guardia's seasonal presence at the less popular Polish Route base camp. Brightly colored tents dot the plateau. The Polish Glacier looms in the distance, and a swift stream - the headwaters of the Vacas river flow from its base. There is an outhouse on the edge of camp. The weekly helicopter retrieval of the 50 gallon drum of waste is a highlight and one of the only things that marks civilized time.

--- Here, each action requires 1 energy point. And without energy, your health will decrease 11 points per action. ---

You can see 'Basecamp Chest' (closed) here.

Energy: 92%  Health: 100%

>look
Basecamp
Plaza Argentina Base Camp (4200m) for Mt. Aconcagua. The trail up to the summit begins here. It's a dangerous, but non-technical climb. There is a collection of ragtag temporary structures that form the Guardia's seasonal presence at the less popular Polish Route base camp. Brightly colored tents dot the plateau. The Polish Glacier looms in the distance, and a swift stream - the headwaters of the Vacas river flow from its base. There is an outhouse on the edge of camp. The weekly helicopter retrieval of the 50 gallon drum of waste is a highlight and one of the only things that marks civilized time.

--- Here, each action requires 1 energy point. And without energy, your health will decrease 11 points per action. ---

You can see 'Basecamp Chest' (closed) here.

Energy: 91%  Health: 100%

>look
Basecamp
Plaza Argentina Base Camp (4200m) for Mt. Aconcagua. The trail up to the summit begins here. It's a dangerous, but non-technical climb. There is a collection of ragtag temporary structures that form the Guardia's seasonal presence at the less popular Polish Route base camp. Brightly colored tents dot the plateau. The Polish Glacier looms in the distance, and a swift stream - the headwaters of the Vacas river flow from its base. There is an outhouse on the edge of camp. The weekly helicopter retrieval of the 50 gallon drum of waste is a highlight and one of the only things that marks civilized time.

--- Here, each action requires 1 energy point. And without energy, your health will decrease 11 points per action. ---

You can see 'Basecamp Chest' (closed) here.

Energy: 90%  Health: 100%

>look
Basecamp
Plaza Argentina Base Camp (4200m) for Mt. Aconcagua. The trail up to the summit begins here. It's a dangerous, but non-technical climb. There is a collection of ragtag temporary structures that form the Guardia's seasonal presence at the less popular Polish Route base camp. Brightly colored tents dot the plateau. The Polish Glacier looms in the distance, and a swift stream - the headwaters of the Vacas river flow from its base. There is an outhouse on the edge of camp. The weekly helicopter retrieval of the 50 gallon drum of waste is a highlight and one of the only things that marks civilized time.

--- Here, each action requires 1 energy point. And without energy, your health will decrease 11 points per action. ---

You can see 'Basecamp Chest' (closed) here.

Energy: 89%  Health: 100%

>look
Basecamp
Plaza Argentina Base Camp (4200m) for Mt. Aconcagua. The trail up to the summit begins here. It's a dangerous, but non-technical climb. There is a collection of ragtag temporary structures that form the Guardia's seasonal presence at the less popular Polish Route base camp. Brightly colored tents dot the plateau. The Polish Glacier looms in the distance, and a swift stream - the headwaters of the Vacas river flow from its base. There is an outhouse on the edge of camp. The weekly helicopter retrieval of the 50 gallon drum of waste is a highlight and one of the only things that marks civilized time.

--- Here, each action requires 1 energy point. And without energy, your health will decrease 11 points per action. ---

You can see 'Basecamp Chest' (closed) here.

Energy: 88%  Health: 100%

>look
Basecamp
Plaza Argentina Base Camp (4200m) for Mt. Aconcagua. The trail up to the summit begins here. It's a dangerous, but non-technical climb. There is a collection of ragtag temporary structures that form the Guardia's seasonal presence at the less popular Polish Route base camp. Brightly colored tents dot the plateau. The Polish Glacier looms in the distance, and a swift stream - the headwaters of the Vacas river flow from its base. There is an outhouse on the edge of camp. The weekly helicopter retrieval of the 50 gallon drum of waste is a highlight and one of the only things that marks civilized time.

--- Here, each action requires 1 energy point. And without energy, your health will decrease 11 points per action. ---

You can see 'Basecamp Chest' (closed) here.

Energy: 87%  Health: 100%

>look
Basecamp
Plaza Argentina Base Camp (4200m) for Mt. Aconcagua. The trail up to the summit begins here. It's a dangerous, but non-technical climb. There is a collection of ragtag temporary structures that form the Guardia's seasonal presence at the less popular Polish Route base camp. Brightly colored tents dot the plateau. The Polish Glacier looms in the distance, and a swift stream - the headwaters of the Vacas river flow from its base. There is an outhouse on the edge of camp. The weekly helicopter retrieval of the 50 gallon drum of waste is a highlight and one of the only things that marks civilized time.

--- Here, each action requires 1 energy point. And without energy, your health will decrease 11 points per action. ---

You can see 'Basecamp Chest' (closed) here.

Energy: 86%  Health: 100%

>look
Basecamp
Plaza Argentina Base Camp (4200m) for Mt. Aconcagua. The trail up to the summit begins here. It's a dangerous, but non-technical climb. There is a collection of ragtag temporary structures that form the Guardia's seasonal presence at the less popular Polish Route base camp. Brightly colored tents dot the plateau. The Polish Glacier looms in the distance, and a swift stream - the headwaters of the Vacas river flow from its base. There is an outhouse on the edge of camp. The weekly helicopter retrieval of the 50 gallon drum of waste is a highlight and one of the only things that marks civilized time.

--- Here, each action requires 1 energy point. And without energy, your health will decrease 11 points per action. ---

You can see 'Basecamp Chest' (closed) here.

Energy: 85%  Health: 100%

>look
Basecamp
Plaza Argentina Base Camp (4200m) for Mt. Aconcagua. The trail up to the summit begins here. It's a dangerous, but non-technical climb. There is a collection of ragtag temporary structures that form the Guardia's seasonal presence at the less popular Polish Route base camp. Brightly colored tents dot the plateau. The Polish Glacier looms in the distance, and a swift stream - the headwaters of the Vacas river flow from its base. There is an outhouse on the edge of camp. The weekly helicopter retrieval of the 50 gallon drum of waste is a highlight and one of the only things that marks civilized time.

--- Here, each action requires 1 energy point. And without energy, your health will decrease 11 points per action. ---

You can see 'Basecamp Chest' (closed) here.

Energy: 84%  Health: 100%

>look
Basecamp
Plaza Argentina Base Camp (4200m) for Mt. Aconcagua. The trail up to the summit begins here. It's a dangerous, but non-technical climb. There is a collection of ragtag temporary structures that form the Guardia's seasonal presence at the less popular Polish Route base camp. Brightly colored tents dot the plateau. The Polish Glacier looms in the distance, and a swift stream - the headwaters of the Vacas river flow from its base. There is an outhouse on the edge of camp. The weekly helicopter retrieval of the 50 gallon drum of waste is a highlight and one of the only things that marks civilized time.

--- Here, each action requires 1 energy point. And without energy, your health will decrease 11 points per action. ---

You can see 'Basecamp Chest' (closed) here.

Energy: 83%  Health: 100%

>look
Basecamp
Plaza Argentina Base Camp (4200m) for Mt. Aconcagua. The trail up to the summit begins here. It's a dangerous, but non-technical climb. There is a collection of ragtag temporary structures that form the Guardia's seasonal presence at the less popular Polish Route base camp. Brightly colored tents dot the plateau. The Polish Glacier looms in the distance, and a swift stream - the headwaters of the Vacas river flow from its base. There is an outhouse on the edge of camp. The weekly helicopter retrieval of the 50 gallon drum of waste is a highlight and one of the only things that marks civilized time.

--- Here, each action requires 1 energy point. And without energy, your health will decrease 11 points per action. ---

You can see 'Basecamp Chest' (closed) here.

Energy: 82%  Health: 100%

>look
Basecamp
Plaza Argentina Base Camp (4200m) for Mt. Aconcagua. The trail up to the summit begins here. It's a dangerous, but non-technical climb. There is a collection of ragtag temporary structures that form the Guardia's seasonal presence at the less popular Polish Route base camp. Brightly colored tents dot the plateau. The Polish Glacier looms in the distance, and a swift stream - the headwaters of the Vacas river flow from its base. There is an outhouse on the edge of camp. The weekly helicopter retrieval of the 50 gallon drum of waste is a highlight and one of the only things that marks civilized time.

--- Here, each action requires 1 energy point. And without energy, your health will decrease 11 points per action. ---

You can see 'Basecamp Chest' (closed) here.

Energy: 81%  Health: 100%

>look
Basecamp
Plaza Argentina Base Camp (4200m) for Mt. Aconcagua. The trail up to the summit begins here. It's a dangerous, but non-technical climb. There is a collection of ragtag temporary structures that form the Guardia's seasonal presence at the less popular Polish Route base camp. Brightly colored tents dot the plateau. The Polish Glacier looms in the distance, and a swift stream - the headwaters of the Vacas river flow from its base. There is an outhouse on the edge of camp. The weekly helicopter retrieval of the 50 gallon drum of waste is a highlight and one of the only things that marks civilized time.

--- Here, each action requires 1 energy point. And without energy, your health will decrease 11 points per action. ---

You can see 'Basecamp Chest' (closed) here.

Energy: 80%  Health: 100%

>look
Basecamp
Plaza Argentina Base Camp (4200m) for Mt. Aconcagua. The trail up to the summit begins here. It's a dangerous, but non-technical climb. There is a collection of ragtag temporary structures that form the Guardia's seasonal presence at the less popular Polish Route base camp. Brightly colored tents dot the plateau. The Polish Glacier looms in the distance, and a swift stream - the headwaters of the Vacas river flow from its base. There is an outhouse on the edge of camp. The weekly helicopter retrieval of the 50 gallon drum of waste is a highlight and one of the only things that marks civilized time.

--- Here, each action requires 1 energy point. And without energy, your health will decrease 11 points per action. ---

You can see 'Basecamp Chest' (closed) here.

Energy: 79%  Health: 100%

>look
Basecamp
Plaza Argentina Base Camp (4200m) for Mt. Aconcagua. The trail up to the summit begins here. It's a dangerous, but non-technical climb. There is a collection of ragtag temporary structures that form the Guardia's seasonal presence at the less popular Polish Route base camp. Brightly colored tents dot the plateau. The Polish Glacier looms in the distance, and a swift stream - the headwaters of the Vacas river flow from its base. There is an outhouse on the edge of camp. The weekly helicopter retrieval of the 50 gallon drum of waste is a highlight and one of the only things that marks civilized time.

--- Here, each action requires 1 energy point. And without energy, your health will decrease 11 points per action. ---

You can see 'Basecamp Chest' (closed) here.

Energy: 78%  Health: 100%

>open chest
You open 'Basecamp Chest', revealing a water bottle, an ice axe, a tent and an orange.

Energy: 77%  Health: 100%

>eat orange
(first taking the orange)
Your energy has increased to 100%.

Energy: 99%  Health: 100%

* * *

>x
What do you want to examine?

>x Example Location
You can't see any such thing.

>i
You are carrying nothing.

>N GO
I only understood you as far as wanting to (go) n.

>go n
You can't go that way.

>go w
You can't go that way.

* * *

>map
You pull out the crumpled map.

Current Load: 0%    Max Load: 100%            Energy: 99%    Health: 100%

* * *

>move BB
You can't see any such thing.

>move w
You must name something more substantial.

>go e
BB
You can see Cat here.

>x Cat
You see nothing special about Cat.

>x cat
You see nothing special about Cat.

* * *

>open
(Chest1)
You open Chest1, revealing a sleepsack, an orange and a matchbox.

>x matchbox
In the matchbox is 5 matches.

>strike match
That's not a verb I recognise.

>ignite match
That's not a verb I recognise.

>use match
That's not a verb I recognise.

>x match
You can't see any such thing.

* * *

>open basecamp chest
You open Basecamp chest.

* * *

>open chest
You open 'Basecamp Chest', revealing an orange, a cliff bar, beef jerky, chicken jerky, a water bottle, an ice axe, crampons, a rope, a first aid kit, a tent and a chemical warming pack.

Current Load: 0%    Max Load: 100%            Energy: 99%    Health: 100%

>ACTIONS
Actions listing on.

>take tent
[taking the tent]
Taken.
[taking the tent - succeeded]

Current Load: 0%    Max Load: 0%            Energy: 98%    Health: 100%

>take water
[taking the water bottle]
Taken.
[taking the water bottle - succeeded]

Current Load: 0%    Max Load: 0%            Energy: 97%    Health: 100%

>take axe
[taking the ice axe]
You're carrying too many things already.
[taking the ice axe - failed the can't exceed carrying capacity rule]

Current Load: 0%    Max Load: 0%            Energy: 96%    Health: 100%

* * *

>open chest
You open 'Basecamp Chest', revealing an orange, a cliff bar, beef jerky, chicken jerky, a water bottle, an ice axe, crampons, a rope, a first aid kit, a tent and a chemical warming pack.

Current Load: 0%    Max Load: 100%            Energy: 99%    Health: 100%

>drink water
Aaaaahh! Very refreshing.

Load: 0%  Energy: 100%  Health: 100%

>l
Basecamp
Plaza Argentina Base Camp (4200m) for Mt. Aconcagua. The trail up to the summit begins here. It's a dangerous, but non-technical climb. There is a collection of ragtag temporary structures that form the Guardia's seasonal presence at the less popular Polish Route base camp. Brightly colored tents dot the plateau. The Polish Glacier looms in the distance, and a swift stream - the headwaters of the Vacas river flow from its base. There is an outhouse on the edge of camp. The weekly helicopter retrieval of the 50 gallon drum of waste is a highlight and one of the only things that marks civilized time.

--- Down here, each action requires 1 energy point. And without energy, your health will decrease 11 points per action. ---

You can see 'Basecamp Chest' (in which are a water bottle, an ice axe, a tent (empty) and an orange) here.

Load: 0%  Energy: 99%  Health: 100%

>l
Basecamp
Plaza Argentina Base Camp (4200m) for Mt. Aconcagua. The trail up to the summit begins here. It's a dangerous, but non-technical climb. There is a collection of ragtag temporary structures that form the Guardia's seasonal presence at the less popular Polish Route base camp. Brightly colored tents dot the plateau. The Polish Glacier looms in the distance, and a swift stream - the headwaters of the Vacas river flow from its base. There is an outhouse on the edge of camp. The weekly helicopter retrieval of the 50 gallon drum of waste is a highlight and one of the only things that marks civilized time.

--- Down here, each action requires 1 energy point. And without energy, your health will decrease 11 points per action. ---

You can see 'Basecamp Chest' (in which are a water bottle, an ice axe, a tent (empty) and an orange) here.

Load: 0%  Energy: 98%  Health: 100%

>drink water
Aaaaahh! Very refreshing.

Load: 0%  Energy: 100%  Health: 100%

>x water
Carrying this insulated bottle requires 15% of your load. Each sip replenishes 10% of your energy and there are 5 sips remaining.

Load: 0%  Energy: 99%  Health: 100%

>drink water
Aaaaahh! Very refreshing.

Load: 0%  Energy: 100%  Health: 100%

>x water
Carrying this insulated bottle requires 15% of your load. Each sip replenishes 10% of your energy and there are 4 sips remaining.

Load: 0%  Energy: 99%  Health: 100%

>drink water
Aaaaahh! Very refreshing.

Load: 0%  Energy: 100%  Health: 100%

>drink water
Aaaaahh! Very refreshing.

Load: 0%  Energy: 100%  Health: 100%

>x water
Carrying this insulated bottle requires 15% of your load. Each sip replenishes 10% of your energy and there are 2 sips remaining.

Load: 0%  Energy: 99%  Health: 100%

>drink water
Aaaaahh! Very refreshing.

Load: 0%  Energy: 100%  Health: 100%

>x water
Carrying this insulated bottle requires 15% of your load. Each sip replenishes 10% of your energy and there are 0 sips remaining.

Load: 0%  Energy: 99%  Health: 100%

>drink water
Ooops... you're all out of slush.

Load: 0%  Energy: 98%  Health: 100%

>l
Basecamp
Plaza Argentina Base Camp (4200m) for Mt. Aconcagua. The trail up to the summit begins here. It's a dangerous, but non-technical climb. There is a collection of ragtag temporary structures that form the Guardia's seasonal presence at the less popular Polish Route base camp. Brightly colored tents dot the plateau. The Polish Glacier looms in the distance, and a swift stream - the headwaters of the Vacas river flow from its base. There is an outhouse on the edge of camp. The weekly helicopter retrieval of the 50 gallon drum of waste is a highlight and one of the only things that marks civilized time.

--- Down here, each action requires 1 energy point. And without energy, your health will decrease 11 points per action. ---

You can see 'Basecamp Chest' (in which are a water bottle, an ice axe, a tent (empty) and an orange) here.

Load: 0%  Energy: 97%  Health: 100%

>l
Basecamp
Plaza Argentina Base Camp (4200m) for Mt. Aconcagua. The trail up to the summit begins here. It's a dangerous, but non-technical climb. There is a collection of ragtag temporary structures that form the Guardia's seasonal presence at the less popular Polish Route base camp. Brightly colored tents dot the plateau. The Polish Glacier looms in the distance, and a swift stream - the headwaters of the Vacas river flow from its base. There is an outhouse on the edge of camp. The weekly helicopter retrieval of the 50 gallon drum of waste is a highlight and one of the only things that marks civilized time.

--- Down here, each action requires 1 energy point. And without energy, your health will decrease 11 points per action. ---

You can see 'Basecamp Chest' (in which are a water bottle, an ice axe, a tent (empty) and an orange) here.

Load: 0%  Energy: 96%  Health: 100%

>l
Basecamp
Plaza Argentina Base Camp (4200m) for Mt. Aconcagua. The trail up to the summit begins here. It's a dangerous, but non-technical climb. There is a collection of ragtag temporary structures that form the Guardia's seasonal presence at the less popular Polish Route base camp. Brightly colored tents dot the plateau. The Polish Glacier looms in the distance, and a swift stream - the headwaters of the Vacas river flow from its base. There is an outhouse on the edge of camp. The weekly helicopter retrieval of the 50 gallon drum of waste is a highlight and one of the only things that marks civilized time.

--- Down here, each action requires 1 energy point. And without energy, your health will decrease 11 points per action. ---

You can see 'Basecamp Chest' (in which are a water bottle, an ice axe, a tent (empty) and an orange) here.

Load: 0%  Energy: 95%  Health: 100%

>l
Basecamp
Plaza Argentina Base Camp (4200m) for Mt. Aconcagua. The trail up to the summit begins here. It's a dangerous, but non-technical climb. There is a collection of ragtag temporary structures that form the Guardia's seasonal presence at the less popular Polish Route base camp. Brightly colored tents dot the plateau. The Polish Glacier looms in the distance, and a swift stream - the headwaters of the Vacas river flow from its base. There is an outhouse on the edge of camp. The weekly helicopter retrieval of the 50 gallon drum of waste is a highlight and one of the only things that marks civilized time.

--- Down here, each action requires 1 energy point. And without energy, your health will decrease 11 points per action. ---

You can see 'Basecamp Chest' (in which are a water bottle, an ice axe, a tent (empty) and an orange) here.

Load: 0%  Energy: 94%  Health: 100%

>l
Basecamp
Plaza Argentina Base Camp (4200m) for Mt. Aconcagua. The trail up to the summit begins here. It's a dangerous, but non-technical climb. There is a collection of ragtag temporary structures that form the Guardia's seasonal presence at the less popular Polish Route base camp. Brightly colored tents dot the plateau. The Polish Glacier looms in the distance, and a swift stream - the headwaters of the Vacas river flow from its base. There is an outhouse on the edge of camp. The weekly helicopter retrieval of the 50 gallon drum of waste is a highlight and one of the only things that marks civilized time.

--- Down here, each action requires 1 energy point. And without energy, your health will decrease 11 points per action. ---

You can see 'Basecamp Chest' (in which are a water bottle, an ice axe, a tent (empty) and an orange) here.

Load: 0%  Energy: 93%  Health: 100%

>l
Basecamp
Plaza Argentina Base Camp (4200m) for Mt. Aconcagua. The trail up to the summit begins here. It's a dangerous, but non-technical climb. There is a collection of ragtag temporary structures that form the Guardia's seasonal presence at the less popular Polish Route base camp. Brightly colored tents dot the plateau. The Polish Glacier looms in the distance, and a swift stream - the headwaters of the Vacas river flow from its base. There is an outhouse on the edge of camp. The weekly helicopter retrieval of the 50 gallon drum of waste is a highlight and one of the only things that marks civilized time.

--- Down here, each action requires 1 energy point. And without energy, your health will decrease 11 points per action. ---

You can see 'Basecamp Chest' (in which are a water bottle, an ice axe, a tent (empty) and an orange) here.

Load: 0%  Energy: 92%  Health: 100%

>l
Basecamp
Plaza Argentina Base Camp (4200m) for Mt. Aconcagua. The trail up to the summit begins here. It's a dangerous, but non-technical climb. There is a collection of ragtag temporary structures that form the Guardia's seasonal presence at the less popular Polish Route base camp. Brightly colored tents dot the plateau. The Polish Glacier looms in the distance, and a swift stream - the headwaters of the Vacas river flow from its base. There is an outhouse on the edge of camp. The weekly helicopter retrieval of the 50 gallon drum of waste is a highlight and one of the only things that marks civilized time.

--- Down here, each action requires 1 energy point. And without energy, your health will decrease 11 points per action. ---

You can see 'Basecamp Chest' (in which are a water bottle, an ice axe, a tent (empty) and an orange) here.

Load: 0%  Energy: 91%  Health: 100%

>l
Basecamp
Plaza Argentina Base Camp (4200m) for Mt. Aconcagua. The trail up to the summit begins here. It's a dangerous, but non-technical climb. There is a collection of ragtag temporary structures that form the Guardia's seasonal presence at the less popular Polish Route base camp. Brightly colored tents dot the plateau. The Polish Glacier looms in the distance, and a swift stream - the headwaters of the Vacas river flow from its base. There is an outhouse on the edge of camp. The weekly helicopter retrieval of the 50 gallon drum of waste is a highlight and one of the only things that marks civilized time.

--- Down here, each action requires 1 energy point. And without energy, your health will decrease 11 points per action. ---

You can see 'Basecamp Chest' (in which are a water bottle, an ice axe, a tent (empty) and an orange) here.

Load: 0%  Energy: 90%  Health: 100%

>l
Basecamp
Plaza Argentina Base Camp (4200m) for Mt. Aconcagua. The trail up to the summit begins here. It's a dangerous, but non-technical climb. There is a collection of ragtag temporary structures that form the Guardia's seasonal presence at the less popular Polish Route base camp. Brightly colored tents dot the plateau. The Polish Glacier looms in the distance, and a swift stream - the headwaters of the Vacas river flow from its base. There is an outhouse on the edge of camp. The weekly helicopter retrieval of the 50 gallon drum of waste is a highlight and one of the only things that marks civilized time.

--- Down here, each action requires 1 energy point. And without energy, your health will decrease 11 points per action. ---

You can see 'Basecamp Chest' (in which are a water bottle, an ice axe, a tent (empty) and an orange) here.

Load: 0%  Energy: 89%  Health: 100%

>l
Basecamp
Plaza Argentina Base Camp (4200m) for Mt. Aconcagua. The trail up to the summit begins here. It's a dangerous, but non-technical climb. There is a collection of ragtag temporary structures that form the Guardia's seasonal presence at the less popular Polish Route base camp. Brightly colored tents dot the plateau. The Polish Glacier looms in the distance, and a swift stream - the headwaters of the Vacas river flow from its base. There is an outhouse on the edge of camp. The weekly helicopter retrieval of the 50 gallon drum of waste is a highlight and one of the only things that marks civilized time.

--- Down here, each action requires 1 energy point. And without energy, your health will decrease 11 points per action. ---

You can see 'Basecamp Chest' (in which are a water bottle, an ice axe, a tent (empty) and an orange) here.

Load: 0%  Energy: 88%  Health: 100%

>l
Basecamp
Plaza Argentina Base Camp (4200m) for Mt. Aconcagua. The trail up to the summit begins here. It's a dangerous, but non-technical climb. There is a collection of ragtag temporary structures that form the Guardia's seasonal presence at the less popular Polish Route base camp. Brightly colored tents dot the plateau. The Polish Glacier looms in the distance, and a swift stream - the headwaters of the Vacas river flow from its base. There is an outhouse on the edge of camp. The weekly helicopter retrieval of the 50 gallon drum of waste is a highlight and one of the only things that marks civilized time.

--- Down here, each action requires 1 energy point. And without energy, your health will decrease 11 points per action. ---

You can see 'Basecamp Chest' (in which are a water bottle, an ice axe, a tent (empty) and an orange) here.

Load: 0%  Energy: 87%  Health: 100%

>l
Basecamp
Plaza Argentina Base Camp (4200m) for Mt. Aconcagua. The trail up to the summit begins here. It's a dangerous, but non-technical climb. There is a collection of ragtag temporary structures that form the Guardia's seasonal presence at the less popular Polish Route base camp. Brightly colored tents dot the plateau. The Polish Glacier looms in the distance, and a swift stream - the headwaters of the Vacas river flow from its base. There is an outhouse on the edge of camp. The weekly helicopter retrieval of the 50 gallon drum of waste is a highlight and one of the only things that marks civilized time.

--- Down here, each action requires 1 energy point. And without energy, your health will decrease 11 points per action. ---

You can see 'Basecamp Chest' (in which are a water bottle, an ice axe, a tent (empty) and an orange) here.

Load: 0%  Energy: 86%  Health: 100%

>drink water
Ooops... you're all out of slush.

Load: 0%  Energy: 85%  Health: 100%

* * *

>open chest
You open 'Basecamp Chest', revealing an orange, a cliff bar, beef jerky, chicken jerky, a water bottle, an ice axe, crampons, a rope, a first aid kit, a tent and a chemical warming pack.

Current Load: 0%    Max Load: 100%            Energy: 99%    Health: 100%

>eat jerky
Which do you mean, beef jerky or chicken jerky?

>eat chicken jerky
(first taking chicken jerky)
Your energy has increased a bit.

Current Load: 10%    Max Load: 100%            Energy: 100%    Health: 100%

>x chicken jerky
You can't see any such thing.

>x beef jerky
Beef jerky can replenish 25% of your energy but requires 10% of your load.

Current Load: 10%    Max Load: 100%            Energy: 99%    Health: 100%

>take all
orange: Taken.
cliff bar: Taken.
beef jerky: Taken.
water bottle: Taken.
ice axe: Taken.
crampons: Taken.
rope: Taken.
tent: You're at max capacity. At this elevation you're max load is 100% and you're currently holding 84%, but this item requires an additional 20%.
chemical warming pack: Taken.

Current Load: 92%    Max Load: 100%            Energy: 98%    Health: 100%

>drop rope, cliff bar
rope: Dropped.
cliff bar: Dropped.

Current Load: 76%    Max Load: 100%            Energy: 97%    Health: 100%

>drop bottle
Dropped.

Current Load: 61%    Max Load: 100%            Energy: 96%    Health: 100%

>go n
Before heading up to Camp1, you should at least bring food, water, shelter, and an ice axe.

Current Load: 61%    Max Load: 100%            Energy: 95%    Health: 100%

>go n
Before heading up to Camp1, you should at least bring food, water, shelter, and an ice axe.

Current Load: 61%    Max Load: 100%            Energy: 94%    Health: 100%

>go n
Before heading up to Camp1, you should at least bring food, water, shelter, and an ice axe.

Current Load: 61%    Max Load: 100%            Energy: 93%    Health: 100%

>i
You are carrying:
  a chemical warming pack
  crampons
  an ice axe
  beef jerky
  an orange

Current Load: 61%    Max Load: 100%            Energy: 92%    Health: 100%

>take bottle
Taken.

Current Load: 76%    Max Load: 100%            Energy: 91%    Health: 100%

>i
You are carrying:
  a water bottle
  a chemical warming pack
  crampons
  an ice axe
  beef jerky
  an orange

Current Load: 76%    Max Load: 100%            Energy: 90%    Health: 100%

>drop crampons
Dropped.

Current Load: 61%    Max Load: 100%            Energy: 89%    Health: 100%

>go n
Before heading up to Camp1, you should at least bring food, water, shelter, and an ice axe.

Current Load: 61%    Max Load: 100%            Energy: 88%    Health: 100%

>i
You are carrying:
  a water bottle
  a chemical warming pack
  an ice axe
  beef jerky
  an orange

Current Load: 61%    Max Load: 100%            Energy: 87%    Health: 100%

>take tent
Taken.

Current Load: 81%    Max Load: 100%            Energy: 86%    Health: 100%

>drop orange
Dropped.

Current Load: 78%    Max Load: 100%            Energy: 85%    Health: 100%

>go n
Are you sure you want to go to Camp1? This hike will require 20 energy.

>y
You make the trek to Camp1.

Camp1
Camp 1 (4900m)  At 16,076 feet above sea level, Camp 1 is higher than most people have every climbed. It is higher than any peak in North America. It is just 1000 feet lower than Everest Base Camp in Nepal. Camp 1 is located at the top of the trail on a plateau. Aconcagua is not visible from here, but its sister, Mt. Ameguino's snowy peak looms above you. The camp is located several hundred meters from the glacial stream. There is no outhouse (you must bury your waste, away from any area that could contaminate the stream). Carrying water from the stream to boil for hydration and cooking is required. You can only carry part of what you need to Camp 1 on your first trip, so you must plan carefully. Climbers stay one night in Camp 1, then return to Base Camp for more supplies. You have to bring the bare essentials - tent, sleeping bag, camp stove, food. You don't immediately need ice climbing equipment - mountaineering boots, crampons, ice ax, harness, helmet, rope. But you will eventually need to bring up to Camp 1, as it's needed at higher elevations.

--- Here, each action requires 2 energy points. And without energy, your health will decrease 12 points per action. ---

Current Load: 78%    Max Load: 100%            Energy: 63%    Health: 100%

>go n
You won't be able to carry all that up there because your max load at Camp2 is only 75%. You have to drop some items (though you can always come back for them).

Current Load: 78%    Max Load: 100%            Energy: 61%    Health: 100%

>i
You are carrying:
  a tent
  a water bottle
  a chemical warming pack
  an ice axe
  beef jerky

Current Load: 78%    Max Load: 100%            Energy: 59%    Health: 100%

>drop tent
Dropped.

Current Load: 58%    Max Load: 100%            Energy: 57%    Health: 100%

>go n
Are you sure you want to go to Camp2? A glacier is blocking the path and there's no way around it... climbing it is risky and will require 30 energy.

>y
You begin the climb to Camp2.

You climb, climb, and climb.

Your limbs want to give up - but you won't let them.

Aside from a few near death experiences, you finally make it to the top!

Camp2
Camp 2 (5850m) Camp 2 is located at the base of visible portions of the Polish Glacier. Below, it retreats under the moraine, but above you, it appears as a both a wall and a river of blue-green ice and white pillars. These are Los Penitentes, statues in ice guarding the glacier. From here, you can see all the way to the Valle de Vacas. Just like with portages from Plaza Argentina to Camp 1, you must make several trips over 3 days from Camp 1 to Camp 2 to haul the rest of your gear. You leave almost nothing behind at Camp 1, except for an emergency shelter tent and some provisions. You have the option of stashing extra water and saving some of your favorite food for the descent.

--- At this altitude, each action requires 5 energy points. And without energy, your health will decrease 15 points per action. ---

Current Load: 58%    Max Load: 100%            Energy: 22%    Health: 100%

>go n
You won't be able to carry all that up there because your max load at Camp3 is only 40%. You have to drop some items (though you can always come back for them).

Current Load: 58%    Max Load: 100%            Energy: 17%    Health: 100%

Your energy is low! You need food, water, or rest.

>i
You are carrying:
  a water bottle
  a chemical warming pack
  an ice axe
  beef jerky

Current Load: 58%    Max Load: 100%            Energy: 12%    Health: 100%

>eat jerky
increased by 25 to 37
Your energy has increased a bit.

Current Load: 48%    Max Load: 100%            Energy: 32%    Health: 100%

>go n
You won't be able to carry all that up there because your max load at Camp3 is only 40%. You have to drop some items (though you can always come back for them).

Current Load: 48%    Max Load: 100%            Energy: 27%    Health: 100%

>drop axe
Dropped.

Current Load: 33%    Max Load: 100%            Energy: 22%    Health: 100%

>go n
Are you sure you want to go to Camp3? This hike will require 30 energy.

>i
Please answer yes or no.

>drop bottle
Please answer yes or no.

>y
You make the trek to Camp3.

Camp3
Camp 3 (400m elevation gain). No one stays in Camp 3 for long. It is above the "kill zone" where lack of oxygen and hypoxia can cause rapid deterioration in your mental and physical state. If you decide to use Camp 3, it's only for a quick stop over so you can be up well before sunrise to attempt the summit. You take only the bare essentials: shelter, food, safety equipment, and your climbing gear. You leave your tent and sleeping bag behind, but you won't be staying at Camp 3 after the summit. You will stop to retrieve your equipment, if you survive the summit, but that's it. If you choose to summit from Camp 3, you will have less climbing to do, but you will also be weaker from the extra time at altitude.

--- Way up here, each action requires 10 energy points. And without energy, your health will decrease 20 points per action. ---

Current Load: 33%    Max Load: 100%            Energy: 12%    Health: 100%

>i
You are carrying:
  a water bottle
  a chemical warming pack

Current Load: 33%    Max Load: 100%            Energy: 2%    Health: 100%

>use chemical warming pack
increased by 5 to 7increased by 25 to 32Your energy has increased a bit, plus a warming boost since it's so cold up here. 5 25
Current Load: 33%    Max Load: 100%            Energy: 22%    Health: 100%

>look
Camp3
Camp 3 (400m elevation gain). No one stays in Camp 3 for long. It is above the "kill zone" where lack of oxygen and hypoxia can cause rapid deterioration in your mental and physical state. If you decide to use Camp 3, it's only for a quick stop over so you can be up well before sunrise to attempt the summit. You take only the bare essentials: shelter, food, safety equipment, and your climbing gear. You leave your tent and sleeping bag behind, but you won't be staying at Camp 3 after the summit. You will stop to retrieve your equipment, if you survive the summit, but that's it. If you choose to summit from Camp 3, you will have less climbing to do, but you will also be weaker from the extra time at altitude.

--- Way up here, each action requires 10 energy points. And without energy, your health will decrease 20 points per action. ---

Current Load: 33%    Max Load: 100%            Energy: 12%    Health: 100%

* * *

>eat jerky
Which do you mean, beef jerky or chicken jerky?

>eat orange
You're not hungry right now.

Current Load: 0%    Max Load: 0%            Energy: 99%    Health: 100%

* * *

>open chest
You open 'Basecamp Chest', revealing an orange, a cliff bar, beef jerky, chicken jerky, a water bottle, an ice axe, crampons, a rope, a first aid kit, a tent and a chemical warming pack.

Current Load: 0%    Max Load: 100%            Energy: 99%    Health: 100%

>eat orange
(first taking the orange)
Your energy has increased abit.

Current Load: 0%    Max Load: 0%            Energy: 100%    Health: 100%

>eat jerky
You can't see any such thing.

>i
You are carrying nothing.

Current Load: 0%    Max Load: 0%            Energy: 99%    Health: 100%

>open chest
That's already open.

Current Load: 0%    Max Load: 0%            Energy: 98%    Health: 100%

>x chest
In 'Basecamp Chest' are a backpack, a cliff bar, a water bottle, an ice axe, crampons, a rope, a tent, a chemical warming pack and a small pack of jerkey.

Current Load: 0%    Max Load: 0%            Energy: 97%    Health: 100%

* * *

>eat orange
(first taking the orange)
Your energy has increased abit.

Current Load: 0%    Max Load: 0%            Energy: 100%    Health: 100%

>energize self
That's not a verb I recognise.

>energize the player
That's not a verb I recognise.

>x chest
In 'Basecamp Chest' are a water bottle, an ice axe and a tent.

Energy: 98%  Health: 100%

* * *

>eat orange
(first taking the orange)
Your energy has increased abit.

Current Load: 0%    Max Load: 0%            Energy: 100%    Health: 100%

>i
You are carrying nothing.

Current Load: 0%    Max Load: 0%            Energy: 97%    Health: 100%

>wear backpack
(first taking the backpack)
You put on the backpack.

Current Load: 0%    Max Load: 100%            Energy: 96%    Health: 100%

>take all
orange: Taken.
cliff bar: (putting the orange into the backpack to make room)
Taken.
water bottle: (putting the cliff bar into the backpack to make room)
Taken.
ice axe: (putting the water bottle into the backpack to make room)
Taken.
crampons: (putting the ice axe into the backpack to make room)
Taken.
rope: (putting crampons into the backpack to make room)
Taken.
tent: (putting the rope into the backpack to make room)
Taken.
chemical warming pack: (putting the tent into the backpack to make room)
Taken.
small pack of jerkey: (putting the chemical warming pack into the backpack to make room)
Taken.

Current Load: 92%    Max Load: 100%            Energy: 95%    Health: 100%

>i
You are carrying:
  a small pack of jerkey
  a backpack (being worn and open)
    a chemical warming pack
    a tent
    a rope
    crampons
    an ice axe
    a water bottle
    a cliff bar
    an orange

Current Load: 92%    Max Load: 100%            Energy: 94%    Health: 100%

>take orange
(putting the small pack of jerkey into the backpack to make room)
Taken.

Current Load: 95%    Max Load: 100%            Energy: 93%    Health: 100%

>i
You are carrying:
  an orange
  a backpack (being worn and open)
    a small pack of jerkey
    a chemical warming pack
    a tent
    a rope
    crampons
    an ice axe
    a water bottle
    a cliff bar

Current Load: 95%    Max Load: 100%            Energy: 92%    Health: 100%

>x
What do you want to examine?

>x self
As good-looking as ever.

Current Load: 95%    Max Load: 100%            Energy: 91%    Health: 100%

>i
You are carrying:
  an orange
  a backpack (being worn and open)
    a small pack of jerkey
    a chemical warming pack
    a tent
    a rope
    crampons
    an ice axe
    a water bottle
    a cliff bar

Current Load: 95%    Max Load: 100%            Energy: 90%    Health: 100%

* * *

>open chest
You open 'Basecamp Chest', revealing an orange, a cliff bar, beef jerky, chicken jerky, a water bottle, an ice axe, crampons, a rope, a first aid kit, a tent and a chemical warming pack.

Current Load: 0%    Max Load: 100%            Energy: 99%    Health: 100%

>end
That's not a verb I recognise.

>die
That's not a verb I recognise.

>look
Basecamp
Plaza Argentina Base Camp (4200m). Plaza Argentina is a collection of ragtag temporary structures that form the Guardia's seasonal presence at the less popular Polish Route base camp. Brightly colored tents dot the plateau. The Polish Glacier looms in the distance, and a swift stream - the headwaters of the Vacas river flow from its base. There is an outhouse on the edge of camp. The weekly helicopter retrieval of the 50 gallon drum of waste is a highlight and one of the only things that marks civilized time.

--- Here, each action requires 1 energy point. And without energy, your health will decrease 11 points per action. ---

You can see 'Basecamp Chest' (in which are a match, a sleepsack (empty) and an orange) here.

Energy: 0%  Health: 100%

>look
Basecamp
Plaza Argentina Base Camp (4200m). Plaza Argentina is a collection of ragtag temporary structures that form the Guardia's seasonal presence at the less popular Polish Route base camp. Brightly colored tents dot the plateau. The Polish Glacier looms in the distance, and a swift stream - the headwaters of the Vacas river flow from its base. There is an outhouse on the edge of camp. The weekly helicopter retrieval of the 50 gallon drum of waste is a highlight and one of the only things that marks civilized time.

--- Here, each action requires 1 energy point. And without energy, your health will decrease 11 points per action. ---

You can see 'Basecamp Chest' (in which are a match, a sleepsack (empty) and an orange) here.

Energy: 0%  Health: 100%

>open chest
That's already open.

Energy: 0%  Health: 100%

>look
Basecamp
Plaza Argentina Base Camp (4200m). Plaza Argentina is a collection of ragtag temporary structures that form the Guardia's seasonal presence at the less popular Polish Route base camp. Brightly colored tents dot the plateau. The Polish Glacier looms in the distance, and a swift stream - the headwaters of the Vacas river flow from its base. There is an outhouse on the edge of camp. The weekly helicopter retrieval of the 50 gallon drum of waste is a highlight and one of the only things that marks civilized time.

--- Here, each action requires 1 energy point. And without energy, your health will decrease 11 points per action. ---

You can see 'Basecamp Chest' (in which are a match, a sleepsack (empty) and an orange) here.

Energy: 0%  Health: 100%

>x matchbox
In the matchbox is 5 matches.

>take 2 matches
Only one of those is available.

>take match
You can't see any such thing.

>x matchbox
In the matchbox is 5 matches.

>take match
You can't see any such thing.

>take match from matchbox
You can't see any such thing.

>take matche from matchbox
You can't see any such thing.

* * *

>open chest
You open 'Basecamp Chest', revealing an orange, a cliff bar, beef jerky, chicken jerky, a water bottle, an ice axe, crampons, a rope, a first aid kit, a tent and a chemical warming pack.

Current Load: 0%    Max Load: 100%            Energy: 99%    Health: 100%

>enter sleepsack
(getting into Chest1)
That's not something you can enter.

>take sleepsack
Taken.

>i
You are carrying:
  a sleepsack

>enter sleepsack
You can only get into something free-standing.

>place sleepsack
That's not a verb I recognise.

>drop sleepsack
Dropped.

>enter sleepsack
You get into the sleepsack.

* * *

>open chest
You open 'Basecamp Chest', revealing an orange, a cliff bar, beef jerky, chicken jerky, a water bottle, an ice axe, crampons, a rope, a first aid kit, a tent and a chemical warming pack.

Current Load: 0%    Max Load: 100%            Energy: 99%    Health: 100%

>grab tent
That's not a verb I recognise.

>take tent
Taken.

Load: 0%  Energy: 98%  Health: 100%

>take axe
You're carrying too many things already.

Load: 0%  Energy: 97%  Health: 100%

>i
You are carrying:
  a tent

Load: 0%  Energy: 96%  Health: 100%

* * *

>open chest
You open 'Basecamp Chest', revealing an orange, a cliff bar, beef jerky, chicken jerky, a water bottle, an ice axe, crampons, a rope, a first aid kit, a tent and a chemical warming pack.

Current Load: 0%    Max Load: 100%            Energy: 99%    Health: 100%

>i
You are carrying nothing.

Current Load: 0%    Max Load: 100%            Energy: 98%    Health: 100%

>eat jerky
The small pack of jerky might be edible, but you probably don't want test it out now.

Current Load: 0%    Max Load: 100%            Energy: 97%    Health: 100%

* * *

>open chest
You open 'Basecamp Chest', revealing an orange, a cliff bar, beef jerky, chicken jerky, a water bottle, an ice axe, crampons, a rope, a first aid kit, a tent and a chemical warming pack.

Current Load: 0%    Max Load: 100%            Energy: 99%    Health: 100%

>open chest1
You open Chest1, revealing an orange.

>close chest1
You close chest1.

>x chest1
You see nothing special about chest1.

* * *

>open chest1
You open Chest1, revealing an orange.

>eat orange
(first taking the orange)
You eat the orange. Not bad.

* * *

>open chest1
You open Chest1, revealing an orange.

>open chest1
That's already open.

>eat orange
That's plainly inedible.

* * *

>open chest
You open 'Basecamp Chest', revealing an orange, a cliff bar, beef jerky, chicken jerky, a water bottle, an ice axe, crampons, a rope, a first aid kit, a tent and a chemical warming pack.

Current Load: 0%    Max Load: 100%            Energy: 99%    Health: 100%

>open matchbox
You open the matchbox.

>x matchbox
The matchbox is empty.

>take match
You can't see any such thing.

>burn match
You can't see any such thing.

>take 1 match
You can't see any such thing.

>take a match
You can't see any such thing.

>open matchbox
That's already open.

>x matchbox
In the matchbox is 5 matches.

>open matchbox
That's already open.

* * *

>open chest
You open 'Basecamp Chest', revealing an orange, a cliff bar, beef jerky, chicken jerky, a water bottle, an ice axe, crampons, a rope, a first aid kit, a tent and a chemical warming pack.

Current Load: 0%    Max Load: 100%            Energy: 99%    Health: 100%

>place tent
That's not a verb I recognise.

>take tent
Taken.

Current Load: 20%    Max Load: 100%            Energy: 98%    Health: 100%

>drop tent
Dropped.

Current Load: 0%    Max Load: 100%            Energy: 97%    Health: 100%

>enter tent
You enter the tent. It's nice and cozy inside.

Current Load: 0%    Max Load: 100%            Energy: 100%    Health: 100%

>get out
You get out of the tent.

Basecamp
Plaza Argentina Base Camp (4200m) for Mt. Aconcagua. The trail up to the summit begins here. It's a dangerous, but non-technical climb. There is a collection of ragtag temporary structures that form the Guardia's seasonal presence at the less popular Polish Route base camp. Brightly colored tents dot the plateau. The Polish Glacier looms in the distance, and a swift stream - the headwaters of the Vacas river flow from its base. There is an outhouse on the edge of camp. The weekly helicopter retrieval of the 50 gallon drum of waste is a highlight and one of the only things that marks civilized time.

--- Down here, each action requires 1 energy point. And without energy, your health will decrease 11 points per action. ---

You can see a tent (empty) and 'Basecamp Chest' (in which are an orange, a cliff bar, beef jerky, chicken jerky, a water bottle, an ice axe, crampons, a rope, a first aid kit and a chemical warming pack) here.

Current Load: 0%    Max Load: 100%            Energy: 99%    Health: 100%

* * *

>open chest
You open 'Basecamp Chest', revealing an orange, a cliff bar, beef jerky, chicken jerky, a water bottle, an ice axe, crampons, a rope, a first aid kit, a tent and a chemical warming pack.

Current Load: 0%    Max Load: 100%            Energy: 99%    Health: 100%

>take a match
You can't see any such thing.

>take match
You can't see any such thing.

>take 5 matches
Taken.

>x chest
In 'Basecamp Chest' are a sleepsack and an orange.

>i
You are carrying:
  5 matches

* * *

>open chest
You open 'Basecamp Chest', revealing an orange, a cliff bar, beef jerky, chicken jerky, a water bottle, an ice axe, crampons, a rope, a first aid kit, a tent and a chemical warming pack.

Current Load: 0%    Max Load: 100%            Energy: 99%    Health: 100%

>take all
orange: Taken.
cliff bar: Taken.
beef jerky: Taken.
chicken jerky: Taken.
water bottle: Taken.
ice axe: Taken.
crampons: Taken.
rope: Taken.
tent: You're at max capacity. At this elevation you're max load is 100% and you're currently holding 84%, but this item requires an additional 20%.
chemical warming pack: Taken.

Current Load: 92%    Max Load: 100%            Energy: 98%    Health: 100%

>ACTIONS
Actions listing on.

>take all
[taking the water bottle]
water bottle: Make sure you're wearing a backpack.
[taking the water bottle - failed]
[taking the ice axe]
ice axe: Make sure you're wearing a backpack.
[taking the ice axe - failed]
[taking the tent]
tent: Make sure you're wearing a backpack.
[taking the tent - failed]
[taking the orange]
orange: Make sure you're wearing a backpack.
[taking the orange - failed]

Load: 0%  Energy: 97%  Health: 100%

* * *

>take all
orange: Taken.
cliff bar: Taken.
beef jerky: Taken.
chicken jerky: Taken.
water bottle: Taken.
ice axe: Taken.
crampons: Taken.
rope: Taken.
tent: You're at max capacity. At this elevation you're max load is 100% and you're currently holding 84%, but this item requires an additional 20%.
chemical warming pack: Taken.

Current Load: 92%    Max Load: 100%            Energy: 98%    Health: 100%

>drop chicken
Dropped.

Current Load: 82%    Max Load: 100%            Energy: 97%    Health: 100%

>take tent
You're at max capacity. At this elevation you're max load is 100% and you're currently holding 82%, but this item requires an additional 20%.

Current Load: 82%    Max Load: 100%            Energy: 96%    Health: 100%

>go n
Before heading up to Camp1, you should at least bring food, water, shelter, and an ice axe.

Current Load: 82%    Max Load: 100%            Energy: 95%    Health: 100%

>drop orange
Dropped.

Current Load: 79%    Max Load: 100%            Energy: 94%    Health: 100%

>go n
Before heading up to Camp1, you should at least bring food, water, shelter, and an ice axe.

Current Load: 79%    Max Load: 100%            Energy: 93%    Health: 100%

>i
You are carrying:
  a chemical warming pack
  a rope
  crampons
  an ice axe
  a water bottle
  beef jerky
  a cliff bar

Current Load: 79%    Max Load: 100%            Energy: 92%    Health: 100%

>take tent
Taken.

Current Load: 99%    Max Load: 100%            Energy: 91%    Health: 100%

>go n
Are you sure you want to go to Camp1? This hike will require 20 energy.

>y
You make the trek to Camp1.

Camp1
Camp 1 (4900m)  At 16,076 feet above sea level, Camp 1 is higher than most people have every climbed. It is higher than any peak in North America. It is just 1000 feet lower than Everest Base Camp in Nepal. Camp 1 is located at the top of the trail on a plateau. Aconcagua is not visible from here, but its sister, Mt. Ameguino's snowy peak looms above you. The camp is located several hundred meters from the glacial stream. There is no outhouse (you must bury your waste, away from any area that could contaminate the stream). Carrying water from the stream to boil for hydration and cooking is required. You can only carry part of what you need to Camp 1 on your first trip, so you must plan carefully. Climbers stay one night in Camp 1, then return to Base Camp for more supplies. You have to bring the bare essentials - tent, sleeping bag, camp stove, food. You don't immediately need ice climbing equipment - mountaineering boots, crampons, ice ax, harness, helmet, rope. But you will eventually need to bring up to Camp 1, as it's needed at higher elevations.

--- Here, each action requires 2 energy points. And without energy, your health will decrease 12 points per action. ---

Current Load: 99%    Max Load: 100%            Energy: 69%    Health: 100%

>i
You are carrying:
  a tent
  a chemical warming pack
  a rope
  crampons
  an ice axe
  a water bottle
  beef jerky
  a cliff bar

Current Load: 99%    Max Load: 100%            Energy: 67%    Health: 100%

>x tent
The tent is empty.

Current Load: 99%    Max Load: 100%            Energy: 65%    Health: 100%

>drop warming pack
Dropped.

Current Load: 91%    Max Load: 100%            Energy: 63%    Health: 100%

>eat cliff
Your energy has increased a bit.

Current Load: 85%    Max Load: 100%            Energy: 76%    Health: 100%

>go n
You won't be able to carry all that up there because your max load at Camp2 is only 75%. You have to drop some items (though you can always come back for them).

Current Load: 85%    Max Load: 100%            Energy: 74%    Health: 100%

>drop tent
Dropped.

Current Load: 65%    Max Load: 100%            Energy: 72%    Health: 100%

>go n
Are you sure you want to go to Camp2? A glacier is blocking the path and there's no way around it... there's a 35% chance of success without a fall, plus the total 45% bonus of your climbing gear. The climb will require 30 energy and a fall would reduce your health by 40%.

>y
You begin the climb to Camp2.

You climb, climb, and climb.

Your limbs want to give up - but you won't let them.

Aside from a few near death experiences, you finally make it to the top!

Camp2
Camp 2 (5850m) Camp 2 is located at the base of visible portions of the Polish Glacier. Below, it retreats under the moraine, but above you, it appears as a both a wall and a river of blue-green ice and white pillars. These are Los Penitentes, statues in ice guarding the glacier. From here, you can see all the way to the Valle de Vacas. Just like with portages from Plaza Argentina to Camp 1, you must make several trips over 3 days from Camp 1 to Camp 2 to haul the rest of your gear. You leave almost nothing behind at Camp 1, except for an emergency shelter tent and some provisions. You have the option of stashing extra water and saving some of your favorite food for the descent.

--- At this altitude, each action requires 5 energy points. And without energy, your health will decrease 15 points per action. ---

Current Load: 65%    Max Load: 100%            Energy: 37%    Health: 100%

* * *

>take all
orange: Taken.
cliff bar: Taken.
beef jerky: Taken.
chicken jerky: Taken.
water bottle: Taken.
ice axe: Taken.
crampons: Taken.
rope: Taken.
tent: You're at max capacity. At this elevation you're max load is 100% and you're currently holding 84%, but this item requires an additional 20%.
chemical warming pack: Taken.

Current Load: 92%    Max Load: 100%            Energy: 98%    Health: 100%

>eat orange
Your energy has increased abit.

Current Load: 94%    Max Load: 100%            Energy: 100%    Health: 100%

>i
You are carrying:
  a tent
  a rope
  crampons
  an ice axe
  a water bottle
  a small pack of jerky
  a cliff bar

Current Load: 94%    Max Load: 100%            Energy: 99%    Health: 100%

>eat jerky
Your energy has increased abit.

Current Load: 94%    Max Load: 100%            Energy: 100%    Health: 100%

>go n
Are you sure you want to go to Camp1? This hike will require 20 energy.

>y
You make the trek to Camp1.

Camp1
Camp 1 (4900m)  At 16,076 feet above sea level, Camp 1 is higher than most people have every climbed. It is higher than any peak in North America. It is just 1000 feet lower than Everest Base Camp in Nepal. Camp 1 is located at the top of the trail on a plateau. Aconcagua is not visible from here, but its sister, Mt. Ameguino's snowy peak looms above you. The camp is located several hundred meters from the glacial stream. There is no outhouse (you must bury your waste, away from any area that could contaminate the stream). Carrying water from the stream to boil for hydration and cooking is required. You can only carry part of what you need to Camp 1 on your first trip, so you must plan carefully. Climbers stay one night in Camp 1, then return to Base Camp for more supplies. You have to bring the bare essentials - tent, sleeping bag, camp stove, food. You don't immediately need ice climbing equipment - mountaineering boots, crampons, ice ax, harness, helmet, rope. But you will eventually need to bring up to Camp 1, as it's needed at higher elevations.

--- Here, each action requires 2 energy points. And without energy, your health will decrease 12 points per action. ---

Current Load: 94%    Max Load: 100%            Energy: 78%    Health: 100%

>i
You are carrying:
  a tent
  a rope
  crampons
  an ice axe
  a water bottle
  a cliff bar

Current Load: 94%    Max Load: 100%            Energy: 76%    Health: 100%

>x crampons
Spiky boots. Crampons will decrease your chance of falling while climbing a glacier by 30%. It requires 15% of your load capacity.

Current Load: 94%    Max Load: 100%            Energy: 74%    Health: 100%

>go n
You won't be able to carry all that up there because your max load at Camp2 is only 75%. You have to drop some items (though you can always come back for them).

Current Load: 94%    Max Load: 100%            Energy: 72%    Health: 100%

>drop crampons and rope
crampons: Dropped.
rope: Dropped.

Current Load: 69%    Max Load: 100%            Energy: 70%    Health: 100%

>go n
Are you sure you want to go to Camp2? A glacier is blocking the path and there's no way around it... climbing it is risky and will require 30 energy.

>y
You begin the climb to Camp2.

You climb, climb, and climb.

Your limbs want to give up - but you won't let them.

Aside from a few near death experiences, you finally make it to the top!

Camp2
Camp 2 (5850m) Camp 2 is located at the base of visible portions of the Polish Glacier. Below, it retreats under the moraine, but above you, it appears as a both a wall and a river of blue-green ice and white pillars. These are Los Penitentes, statues in ice guarding the glacier. From here, you can see all the way to the Valle de Vacas. Just like with portages from Plaza Argentina to Camp 1, you must make several trips over 3 days from Camp 1 to Camp 2 to haul the rest of your gear. You leave almost nothing behind at Camp 1, except for an emergency shelter tent and some provisions. You have the option of stashing extra water and saving some of your favorite food for the descent.

--- At this altitude, each action requires 5 energy points. And without energy, your health will decrease 15 points per action. ---

Current Load: 69%    Max Load: 100%            Energy: 35%    Health: 100%

>use first aid kit
That's not a verb I recognise.

* * *

>take all
orange: Taken.
cliff bar: Taken.
beef jerky: Taken.
chicken jerky: Taken.
water bottle: Taken.
ice axe: Taken.
crampons: Taken.
rope: Taken.
tent: You're at max capacity. At this elevation you're max load is 100% and you're currently holding 84%, but this item requires an additional 20%.
chemical warming pack: Taken.

Current Load: 92%    Max Load: 100%            Energy: 98%    Health: 100%

>go n
Are you sure you want to go to Camp1? This hike will require 20 energy.

>y
You make the trek to Camp1.

Camp1
Camp 1 (4900m)  At 16,076 feet above sea level, Camp 1 is higher than most people have every climbed. It is higher than any peak in North America. It is just 1000 feet lower than Everest Base Camp in Nepal. Camp 1 is located at the top of the trail on a plateau. Aconcagua is not visible from here, but its sister, Mt. Ameguino's snowy peak looms above you. The camp is located several hundred meters from the glacial stream. There is no outhouse (you must bury your waste, away from any area that could contaminate the stream). Carrying water from the stream to boil for hydration and cooking is required. You can only carry part of what you need to Camp 1 on your first trip, so you must plan carefully. Climbers stay one night in Camp 1, then return to Base Camp for more supplies. You have to bring the bare essentials - tent, sleeping bag, camp stove, food. You don't immediately need ice climbing equipment - mountaineering boots, crampons, ice ax, harness, helmet, rope. But you will eventually need to bring up to Camp 1, as it's needed at higher elevations.

--- Here, each action requires 2 energy points. And without energy, your health will decrease 12 points per action. ---

Current Load: 94%    Max Load: 100%            Energy: 76%    Health: 100%

>go n
You won't be able to carry all that up there because your max load at Camp2 is only 75%. You have to drop some items (though you can always come back for them).

Current Load: 94%    Max Load: 100%            Energy: 74%    Health: 100%

>drop beef jerky
You can't see any such thing.

>i
You are carrying:
  a tent
  a rope
  crampons
  an ice axe
  a water bottle
  a small pack of jerky
  a cliff bar
  an orange

Current Load: 94%    Max Load: 100%            Energy: 72%    Health: 100%

* * *

>go n
You won't be able to carry all that up there because your max load at Camp2 is only 75%. You have to drop some items (though you can always come back for them).

Current Load: 94%    Max Load: 100%            Energy: 74%    Health: 100%

>y
You make the climb to Camp2.
You climb, climb, and climb. Your limbs want to give up - but you won't let them. Aside from a few near death experiences, you finally make it to the top!

Camp2
Camp 2 (5850m) Camp 2 is located at the base of visible portions of the Polish Glacier. Below, it retreats under the moraine, but above you, it appears as a both a wall and a river of blue-green ice and white pillars. These are Los Penitentes, statues in ice guarding the glacier. From here, you can see all the way to the Valle de Vacas. Just like with portages from Plaza Argentina to Camp 1, you must make several trips over 3 days from Camp 1 to Camp 2 to haul the rest of your gear. You leave almost nothing behind at Camp 1, except for an emergency shelter tent and some provisions. You have the option of stashing extra water and saving some of your favorite food for the descent.

--- At this altitude, each action requires 5 energy points. And without energy, your health will decrease 15 points per action. ---

Load: 0%  Energy: 41%  Health: 100%

>l
Camp2
Camp 2 (5850m) Camp 2 is located at the base of visible portions of the Polish Glacier. Below, it retreats under the moraine, but above you, it appears as a both a wall and a river of blue-green ice and white pillars. These are Los Penitentes, statues in ice guarding the glacier. From here, you can see all the way to the Valle de Vacas. Just like with portages from Plaza Argentina to Camp 1, you must make several trips over 3 days from Camp 1 to Camp 2 to haul the rest of your gear. You leave almost nothing behind at Camp 1, except for an emergency shelter tent and some provisions. You have the option of stashing extra water and saving some of your favorite food for the descent.

--- At this altitude, each action requires 5 energy points. And without energy, your health will decrease 15 points per action. ---

Load: 0%  Energy: 36%  Health: 100%

>ll
That's not a verb I recognise.

>l
Camp2
Camp 2 (5850m) Camp 2 is located at the base of visible portions of the Polish Glacier. Below, it retreats under the moraine, but above you, it appears as a both a wall and a river of blue-green ice and white pillars. These are Los Penitentes, statues in ice guarding the glacier. From here, you can see all the way to the Valle de Vacas. Just like with portages from Plaza Argentina to Camp 1, you must make several trips over 3 days from Camp 1 to Camp 2 to haul the rest of your gear. You leave almost nothing behind at Camp 1, except for an emergency shelter tent and some provisions. You have the option of stashing extra water and saving some of your favorite food for the descent.

--- At this altitude, each action requires 5 energy points. And without energy, your health will decrease 15 points per action. ---

Load: 0%  Energy: 31%  Health: 100%

>l
Camp2
Camp 2 (5850m) Camp 2 is located at the base of visible portions of the Polish Glacier. Below, it retreats under the moraine, but above you, it appears as a both a wall and a river of blue-green ice and white pillars. These are Los Penitentes, statues in ice guarding the glacier. From here, you can see all the way to the Valle de Vacas. Just like with portages from Plaza Argentina to Camp 1, you must make several trips over 3 days from Camp 1 to Camp 2 to haul the rest of your gear. You leave almost nothing behind at Camp 1, except for an emergency shelter tent and some provisions. You have the option of stashing extra water and saving some of your favorite food for the descent.

--- At this altitude, each action requires 5 energy points. And without energy, your health will decrease 15 points per action. ---

Load: 0%  Energy: 26%  Health: 100%

>l
Camp2
Camp 2 (5850m) Camp 2 is located at the base of visible portions of the Polish Glacier. Below, it retreats under the moraine, but above you, it appears as a both a wall and a river of blue-green ice and white pillars. These are Los Penitentes, statues in ice guarding the glacier. From here, you can see all the way to the Valle de Vacas. Just like with portages from Plaza Argentina to Camp 1, you must make several trips over 3 days from Camp 1 to Camp 2 to haul the rest of your gear. You leave almost nothing behind at Camp 1, except for an emergency shelter tent and some provisions. You have the option of stashing extra water and saving some of your favorite food for the descent.

--- At this altitude, each action requires 5 energy points. And without energy, your health will decrease 15 points per action. ---

Load: 0%  Energy: 21%  Health: 100%

>l
Camp2
Camp 2 (5850m) Camp 2 is located at the base of visible portions of the Polish Glacier. Below, it retreats under the moraine, but above you, it appears as a both a wall and a river of blue-green ice and white pillars. These are Los Penitentes, statues in ice guarding the glacier. From here, you can see all the way to the Valle de Vacas. Just like with portages from Plaza Argentina to Camp 1, you must make several trips over 3 days from Camp 1 to Camp 2 to haul the rest of your gear. You leave almost nothing behind at Camp 1, except for an emergency shelter tent and some provisions. You have the option of stashing extra water and saving some of your favorite food for the descent.

--- At this altitude, each action requires 5 energy points. And without energy, your health will decrease 15 points per action. ---

Load: 0%  Energy: 16%  Health: 100%

Your energy is low! You need food, water, or rest.

>l
Camp2
Camp 2 (5850m) Camp 2 is located at the base of visible portions of the Polish Glacier. Below, it retreats under the moraine, but above you, it appears as a both a wall and a river of blue-green ice and white pillars. These are Los Penitentes, statues in ice guarding the glacier. From here, you can see all the way to the Valle de Vacas. Just like with portages from Plaza Argentina to Camp 1, you must make several trips over 3 days from Camp 1 to Camp 2 to haul the rest of your gear. You leave almost nothing behind at Camp 1, except for an emergency shelter tent and some provisions. You have the option of stashing extra water and saving some of your favorite food for the descent.

--- At this altitude, each action requires 5 energy points. And without energy, your health will decrease 15 points per action. ---

Load: 0%  Energy: 11%  Health: 100%

* * *

>take all
orange: Taken.
cliff bar: Taken.
beef jerky: Taken.
chicken jerky: Taken.
water bottle: Taken.
ice axe: Taken.
crampons: Taken.
rope: Taken.
tent: You're at max capacity. At this elevation you're max load is 100% and you're currently holding 84%, but this item requires an additional 20%.
chemical warming pack: Taken.

Current Load: 92%    Max Load: 100%            Energy: 98%    Health: 100%

>go to camp1
Are you sure you want to go to Camp1? This hike will require 20 energy.

>y
You make the trek to Camp1.

Camp1
Camp 1 (4900m)  At 16,076 feet above sea level, Camp 1 is higher than most people have every climbed. It is higher than any peak in North America. It is just 1000 feet lower than Everest Base Camp in Nepal. Camp 1 is located at the top of the trail on a plateau. Aconcagua is not visible from here, but its sister, Mt. Ameguino's snowy peak looms above you. The camp is located several hundred meters from the glacial stream. There is no outhouse (you must bury your waste, away from any area that could contaminate the stream). Carrying water from the stream to boil for hydration and cooking is required. You can only carry part of what you need to Camp 1 on your first trip, so you must plan carefully. Climbers stay one night in Camp 1, then return to Base Camp for more supplies. You have to bring the bare essentials - tent, sleeping bag, camp stove, food. You don't immediately need ice climbing equipment - mountaineering boots, crampons, ice ax, harness, helmet, rope. But you will eventually need to bring up to Camp 1, as it's needed at higher elevations.

--- Here, each action requires 2 energy points. And without energy, your health will decrease 12 points per action. ---

Energy: 76%  Health: 100%

>eat orange
Your energy has increased to 100%.

Energy: 98%  Health: 100%

>look
Camp1
Camp 1 (4900m)  At 16,076 feet above sea level, Camp 1 is higher than most people have every climbed. It is higher than any peak in North America. It is just 1000 feet lower than Everest Base Camp in Nepal. Camp 1 is located at the top of the trail on a plateau. Aconcagua is not visible from here, but its sister, Mt. Ameguino's snowy peak looms above you. The camp is located several hundred meters from the glacial stream. There is no outhouse (you must bury your waste, away from any area that could contaminate the stream). Carrying water from the stream to boil for hydration and cooking is required. You can only carry part of what you need to Camp 1 on your first trip, so you must plan carefully. Climbers stay one night in Camp 1, then return to Base Camp for more supplies. You have to bring the bare essentials - tent, sleeping bag, camp stove, food. You don't immediately need ice climbing equipment - mountaineering boots, crampons, ice ax, harness, helmet, rope. But you will eventually need to bring up to Camp 1, as it's needed at higher elevations.

--- Here, each action requires 2 energy points. And without energy, your health will decrease 12 points per action. ---

Energy: 96%  Health: 100%

>look
Camp1
Camp 1 (4900m)  At 16,076 feet above sea level, Camp 1 is higher than most people have every climbed. It is higher than any peak in North America. It is just 1000 feet lower than Everest Base Camp in Nepal. Camp 1 is located at the top of the trail on a plateau. Aconcagua is not visible from here, but its sister, Mt. Ameguino's snowy peak looms above you. The camp is located several hundred meters from the glacial stream. There is no outhouse (you must bury your waste, away from any area that could contaminate the stream). Carrying water from the stream to boil for hydration and cooking is required. You can only carry part of what you need to Camp 1 on your first trip, so you must plan carefully. Climbers stay one night in Camp 1, then return to Base Camp for more supplies. You have to bring the bare essentials - tent, sleeping bag, camp stove, food. You don't immediately need ice climbing equipment - mountaineering boots, crampons, ice ax, harness, helmet, rope. But you will eventually need to bring up to Camp 1, as it's needed at higher elevations.

--- Here, each action requires 2 energy points. And without energy, your health will decrease 12 points per action. ---

Energy: 94%  Health: 100%

>go to camp2
Are you sure you want to go to Camp2? A glacier is blocking the path and there's no way around it... climbing it is risky and will require 30 energy.

Please answer yes or no.

>y
You make the climb to Camp2.
You climb, climb, and climb. Your limbs want to give up - but you won't let them. Aside from a few near death experiences, you finally make it to the top!

Camp2
Camp 2 (5850m) Camp 2 is located at the base of visible portions of the Polish Glacier. Below, it retreats under the moraine, but above you, it appears as a both a wall and a river of blue-green ice and white pillars. These are Los Penitentes, statues in ice guarding the glacier. From here, you can see all the way to the Valle de Vacas. Just like with portages from Plaza Argentina to Camp 1, you must make several trips over 3 days from Camp 1 to Camp 2 to haul the rest of your gear. You leave almost nothing behind at Camp 1, except for an emergency shelter tent and some provisions. You have the option of stashing extra water and saving some of your favorite food for the descent.

--- Here, each action requires 5 energy points. And without energy, your health will decrease 15 points per action. ---

Energy: 59%  Health: 100%

* * *

>take all
orange: Taken.
cliff bar: Taken.
beef jerky: Taken.
chicken jerky: Taken.
water bottle: Taken.
ice axe: Taken.
crampons: Taken.
rope: Taken.
tent: You're at max capacity. At this elevation you're max load is 100% and you're currently holding 84%, but this item requires an additional 20%.
chemical warming pack: Taken.

Current Load: 92%    Max Load: 100%            Energy: 98%    Health: 100%

>i
You are carrying:
  a backpack (open but empty)

Current Load: 0%    Max Load: 100%            Energy: 97%    Health: 100%

>wear backpack
You put on the backpack.

Current Load: 0%    Max Load: 100%            Energy: 96%    Health: 100%

* * *

>take all
orange: Taken.
cliff bar: Taken.
beef jerky: Taken.
chicken jerky: Taken.
water bottle: Taken.
ice axe: Taken.
crampons: Taken.
rope: Taken.
tent: You're at max capacity. At this elevation you're max load is 100% and you're currently holding 84%, but this item requires an additional 20%.
chemical warming pack: Taken.

Current Load: 92%    Max Load: 100%            Energy: 98%    Health: 100%

>take backpack
You're carrying too many things already.

Load: 0%  Energy: 97%  Health: 100%

>wear backpack
(first taking the backpack)
You're carrying too many things already.

Load: 0%  Energy: 96%  Health: 100%

>drop water bottle
Dropped.

Load: 0%  Energy: 95%  Health: 100%

>take backpack
Make sure you're wearing a backpack.

Taken.

Load: 0%  Energy: 94%  Health: 100%

* * *

>take all
orange: Taken.
cliff bar: Taken.
beef jerky: Taken.
chicken jerky: Taken.
water bottle: Taken.
ice axe: Taken.
crampons: Taken.
rope: Taken.
tent: You're at max capacity. At this elevation you're max load is 100% and you're currently holding 84%, but this item requires an additional 20%.
chemical warming pack: Taken.

Current Load: 92%    Max Load: 100%            Energy: 98%    Health: 100%

>x water bottle
Carrying this insulated bottle requires 15% of your load. Each sip replenishes 10% of your energy and there are 7 sips remaining.

Load: 0%  Energy: 97%  Health: 100%

* * *

>open chest
You open 'Basecamp Chest', revealing an orange, a cliff bar, beef jerky, chicken jerky, a water bottle, an ice axe, crampons, a rope, a first aid kit, a tent and a chemical warming pack.

Current Load: 0%    Max Load: 100%            Energy: 99%    Health: 100%

>take axe
Try taking things once you're wearing a backpack. You can hold a lot more that way, but remember, the higher up you go the less you'll be able to carry.

Current Load: 0%    Max Load: 0%            Energy: 98%    Health: 100%

>take backpack
Taken.

Current Load: 0%    Max Load: 0%            Energy: 97%    Health: 100%

>wear backpack
You're already wearing that!

Load: 0%  Energy: 96%  Health: 100%

>take backpack off
You take off the backpack.

Load: 0%  Energy: 95%  Health: 100%

>ACTIONS
Actions listing on.

>wear backpack
[wearing the backpack]
You put on the backpack.
[wearing the backpack - succeeded]

Load: 0%  Energy: 94%  Health: 100%

* * *

>take axe
Try taking things once you're wearing a backpack. You can hold a lot more that way, but remember, the higher up you go the less you'll be able to carry.

Current Load: 0%    Max Load: 0%            Energy: 98%    Health: 100%

>take water bottle
You'll probably need a backpack to hold all that...

Taken.

Load: 0%  Energy: 97%  Health: 100%

>take tent
You're carrying too many things already.

Load: 0%  Energy: 96%  Health: 100%

* * *

>open chest
You open 'Basecamp Chest', revealing an orange, a cliff bar, beef jerky, chicken jerky, a water bottle, an ice axe, crampons, a rope, a first aid kit, a tent and a chemical warming pack.

Current Load: 0%    Max Load: 100%            Energy: 99%    Health: 100%

>take backpack
Taken.

Current Load: 0%    Max Load: 100%            Energy: 98%    Health: 100%

>drop backpack
(first taking the backpack off)
Dropped.

Current Load: 0%    Max Load: 0%            Energy: 97%    Health: 100%

>take backpack
You're now wearing a backpack.

Current Load: 0%    Max Load: 100%            Energy: 96%    Health: 100%

>wear backpack
Current Load: 0%    Max Load: 100%            Energy: 95%    Health: 100%

* * *

>take backpack
Taken.

Current Load: 0%    Max Load: 100%            Energy: 98%    Health: 100%

>i backpack
I only understood you as far as wanting to take inventory.

>open the backpack
That's already open.

Current Load: 0%    Max Load: 100%            Energy: 97%    Health: 100%

>put orange in backpack
(first taking the orange)
Try taking things once you're wearing a backpack. You can hold a lot more that way, but remember, the higher up you go the less you'll be able to carry.

Current Load: 0%    Max Load: 100%            Energy: 96%    Health: 100%

>ACTIONS put orange in backpack
I only understood you as far as wanting to actions.

>ACTIONS
Actions listing on.

>put orange in backpack
[inserting the orange into the backpack]
(first taking the orange)
[(1) taking the orange - silently]
Try taking things once you're wearing a backpack. You can hold a lot more that way, but remember, the higher up you go the less you'll be able to carry.
[(1) taking the orange - silently - failed]

[inserting the orange into the backpack - failed the can't insert what's not held rule]

Current Load: 0%    Max Load: 100%            Energy: 95%    Health: 100%

* * *

>take backpack
Taken.

Current Load: 0%    Max Load: 100%            Energy: 98%    Health: 100%

>put bottle in backpack
(first taking the water bottle)
Try taking things once you're wearing a backpack. You can hold a lot more that way, but remember, the higher up you go the less you'll be able to carry.

Current Load: 0%    Max Load: 100%            Energy: 97%    Health: 100%

* * *

>take backpack
Taken.

Current Load: 0%    Max Load: 100%            Energy: 98%    Health: 100%

>take backpack
You're now wearing a backpack.

Current Load: 0%    Max Load: 100%            Energy: 97%    Health: 100%

* * *

>take backpack
Taken.

Current Load: 0%    Max Load: 100%            Energy: 98%    Health: 100%

>take orange
Taken.

Current Load: 0%    Max Load: 100%            Energy: 97%    Health: 100%

>i
You are carrying:
  an orange
  a backpack (open but empty)

Current Load: 0%    Max Load: 100%            Energy: 96%    Health: 100%

>wear backpack
You put on the backpack.

Current Load: 0%    Max Load: 100%            Energy: 95%    Health: 100%

>take axe
Taken.

Current Load: 0%    Max Load: 100%            Energy: 94%    Health: 100%

>i
You are carrying:
  an ice axe
  an orange
  a backpack (being worn and open but empty)

Current Load: 0%    Max Load: 100%            Energy: 93%    Health: 100%

* * *

>take backpack
Taken.

Current Load: 0%    Max Load: 100%            Energy: 98%    Health: 100%

>take water bottle
Taken.

Current Load: 0%    Max Load: 0%            Energy: 97%    Health: 100%

* * *

>open chest
You open 'Basecamp Chest', revealing an orange, a cliff bar, beef jerky, chicken jerky, a water bottle, an ice axe, crampons, a rope, a first aid kit, a tent and a chemical warming pack.

Current Load: 0%    Max Load: 100%            Energy: 99%    Health: 100%

>take beef
Taken.

Current Load: 10%    Max Load: 100%            Energy: 98%    Health: 100%

>take chicken
Taken.

Current Load: 20%    Max Load: 100%            Energy: 97%    Health: 100%

>take warming pack
Taken.

Current Load: 28%    Max Load: 100%            Energy: 96%    Health: 100%

>take crampons
Taken.

Current Load: 43%    Max Load: 100%            Energy: 95%    Health: 100%

>take rope
Taken.

Current Load: 53%    Max Load: 100%            Energy: 94%    Health: 100%

>i
You are carrying:
  a rope
  crampons
  a chemical warming pack
  chicken jerky
  beef jerky

Current Load: 53%    Max Load: 100%            Energy: 93%    Health: 100%

>tak water
That's not a verb I recognise.

>take water
Taken.

Current Load: 68%    Max Load: 100%            Energy: 92%    Health: 100%

>take tent
Taken.

Current Load: 88%    Max Load: 100%            Energy: 91%    Health: 100%

>take chicken
You already have that.

Current Load: 98%    Max Load: 100%            Energy: 90%    Health: 100%

>take cliff
You're at max capacity. At this elevation you're max load is 100% and you're currently holding 98%, but this item requires an additional 6%.

Current Load: 98%    Max Load: 100%            Energy: 89%    Health: 100%

>eat orange
(first taking the orange)
You're at max capacity. At this elevation you're max load is 100% and you're currently holding 98%, but this item requires an additional 3%.

Current Load: 98%    Max Load: 100%            Energy: 88%    Health: 100%

>go n
Before heading up to Camp1, you should at least bring food, water, shelter, and an ice axe.

Current Load: 98%    Max Load: 100%            Energy: 87%    Health: 100%

>eat chicken
Your energy has increased a bit.

Current Load: 88%    Max Load: 100%            Energy: 99%    Health: 100%

>take axe
You're at max capacity. At this elevation you're max load is 100% and you're currently holding 88%, but this item requires an additional 15%.

Current Load: 88%    Max Load: 100%            Energy: 98%    Health: 100%

>i
You are carrying:
  a tent
  a water bottle
  a rope
  crampons
  a chemical warming pack
  beef jerky

Current Load: 88%    Max Load: 100%            Energy: 97%    Health: 100%

>drop rope
Dropped.

Current Load: 78%    Max Load: 100%            Energy: 96%    Health: 100%

>take axe
Taken.

Current Load: 93%    Max Load: 100%            Energy: 95%    Health: 100%

>go n
It's dark out, and you need some sleep before making another trek.

Current Load: 93%    Max Load: 100%            Energy: 94%    Health: 100%

* * *

>open chest
You open 'Basecamp Chest', revealing an orange, a cliff bar, beef jerky, chicken jerky, a water bottle, an ice axe, crampons, a rope, a first aid kit, a tent and a chemical warming pack.

Current Load: 0%    Max Load: 100%            Energy: 99%    Health: 100%

>take bottle
You must be wearing a backpack to hold items.

Current Load: 0%    Max Load: 0%            Energy: 98%    Health: 100%

>take backpack
Taken.

Current Load: 0%    Max Load: 100%            Energy: 97%    Health: 100%

>take axe
Taken.

Load: 0%  Energy: 96%  Health: 100%

* * *

>take backpack
Taken.

Current Load: 0%    Max Load: 100%            Energy: 97%    Health: 100%

>take bottle
You must be *wearing* a backpack to hold items.

Current Load: 0%    Max Load: 100%            Energy: 96%    Health: 100%

>wear backpack
You put on the backpack.

Current Load: 0%    Max Load: 100%            Energy: 95%    Health: 100%

>take orange
Taken.

Current Load: 0%    Max Load: 100%            Energy: 94%    Health: 100%

* * *

>take backpack
Taken.

Current Load: 0%    Max Load: 100%            Energy: 97%    Health: 100%

>undo
Basecamp
[Previous turn undone.]

>wear backpack
(first taking the backpack)
You put on the backpack.

Current Load: 0%    Max Load: 100%            Energy: 97%    Health: 100%

>drink water
Aaaaahh! Very refreshing.

Current Load: 0%    Max Load: 100%            Energy: 100%    Health: 100%

>x water
Carrying this insulated bottle requires 15% of your load. Each sip replenishes 10% of your energy and there are 6 sips remaining.

Current Load: 0%    Max Load: 100%            Energy: 99%    Health: 100%

>sip water
Aaaaahh! Very refreshing.

Current Load: 0%    Max Load: 100%            Energy: 100%    Health: 100%

>take a sip of water
You can't see any such thing.

>sip water
Aaaaahh! Very refreshing.

Current Load: 0%    Max Load: 100%            Energy: 100%    Health: 100%

* * *

>open chest
You open 'Basecamp Chest', revealing an orange, a cliff bar, beef jerky, chicken jerky, a water bottle, an ice axe, crampons, a rope, a first aid kit, a tent and a chemical warming pack.

Current Load: 0%    Max Load: 100%            Energy: 99%    Health: 100%

>take match
Taken.

>x chest
In 'Basecamp Chest' are a sleepsack and an orange.

>enter sleepsack
(getting into 'Basecamp Chest')
That's not something you can enter.

>take sleepsack
Taken.

>enter sleepsack
You can only get into something free-standing.

* * *

>place sleepsack
That's not a verb I recognise.

>put down sleepsack
Dropped.

>enter sleepsack
You enter the sleepsack. It's nice and cozy inside.

>sleep
You aren't feeling especially drowsy.

* * *

>open chest
You open 'Basecamp Chest', revealing an orange, a cliff bar, beef jerky, chicken jerky, a water bottle, an ice axe, crampons, a rope, a first aid kit, a tent and a chemical warming pack.

Current Load: 0%    Max Load: 100%            Energy: 99%    Health: 100%

>take matchbox
Taken.

>open matchbox
You open the matchbox.

* * *

>take matchbox
Taken.

>x matchbox
You see nothing special about the matchbox.

>open matchbox
You open the matchbox.

* * *

>open chest
You open 'Basecamp Chest', revealing an orange, a cliff bar, beef jerky, chicken jerky, a water bottle, an ice axe, crampons, a rope, a first aid kit, a tent and a chemical warming pack.

Current Load: 0%    Max Load: 100%            Energy: 99%    Health: 100%

>take orange
You must be wearing a backpack to hold items.

Current Load: 0%    Max Load: 0%            Energy: 98%    Health: 100%

>take backpack
Taken.

Current Load: 0%    Max Load: 100%            Energy: 97%    Health: 100%

>take orange
You're carrying too many things already.

Current Load: 0%    Max Load: 100%            Energy: 96%    Health: 100%

* * *

>open chest
You open 'Basecamp Chest', revealing an orange, a cliff bar, beef jerky, chicken jerky, a water bottle, an ice axe, crampons, a rope, a first aid kit, a tent and a chemical warming pack.

Current Load: 0%    Max Load: 100%            Energy: 99%    Health: 100%

>take sleepsack
Taken.

>drop sleepsack
Dropped.

>enter sleepsack
You enter the sleepsack. It's nice and cozy inside.

* * *

>open chest
You open 'Basecamp Chest', revealing an orange, a cliff bar, beef jerky, chicken jerky, a water bottle, an ice axe, crampons, a rope, a first aid kit, a tent and a chemical warming pack.

Current Load: 0%    Max Load: 100%            Energy: 99%    Health: 100%

>take tent
Taken.

Current Load: 20%    Max Load: 100%            Energy: 98%    Health: 100%

>ACTIONS
Actions listing on.

>take tent
[taking the tent]
U need a bag[taking the tent - failed]

Current Load: 0%    Max Load: 0%            Energy: 97%    Health: 100%

>take backpack
[taking the backpack]
Taken.
[taking the backpack - succeeded]

Current Load: 0%    Max Load: 100%            Energy: 96%    Health: 100%

>take tent
[taking the tent]
U need a bag[taking the tent - failed]

Current Load: 0%    Max Load: 100%            Energy: 95%    Health: 100%

>wear backpack
[wearing the backpack]
You put on the backpack.
[wearing the backpack - succeeded]

Current Load: 0%    Max Load: 100%            Energy: 94%    Health: 100%

>take tent
[taking the tent]
U need a bag[taking the tent - failed]

Current Load: 0%    Max Load: 100%            Energy: 93%    Health: 100%

>i
[taking inventory]
You are carrying:
  a backpack (being worn and open but empty)

[taking inventory - succeeded]

Current Load: 0%    Max Load: 100%            Energy: 92%    Health: 100%

* * *

>enter tent
You enter the tent. It's nice and cozy inside.

Current Load: 0%    Max Load: 100%            Energy: 100%    Health: 100%

>go n
You bump into the tent wall... Maybe you should get out of the tent before traveling.

Current Load: 0%    Max Load: 100%            Energy: 100%    Health: 100%

* * *

>take tent
Taken.

Current Load: 20%    Max Load: 100%            Energy: 98%    Health: 100%

>enter tent
You can only get into something free-standing.

Current Load: 20%    Max Load: 100%            Energy: 97%    Health: 100%

>drop tent
Dropped.

Current Load: 0%    Max Load: 100%            Energy: 96%    Health: 100%

>enter tent
You enter the tent. It's nice and cozy inside.

Current Load: 0%    Max Load: 100%            Energy: 100%    Health: 100%

>take tent
You would have to get out of the tent first.

Current Load: 20%    Max Load: 100%            Energy: 100%    Health: 100%

>get out
You get out of the tent.

Basecamp
Plaza Argentina Base Camp (4200m) for Mt. Aconcagua. The trail up to the summit begins here. It's a dangerous, but non-technical climb. There is a collection of ragtag temporary structures that form the Guardia's seasonal presence at the less popular Polish Route base camp. Brightly colored tents dot the plateau. The Polish Glacier looms in the distance, and a swift stream - the headwaters of the Vacas river flow from its base. There is an outhouse on the edge of camp. The weekly helicopter retrieval of the 50 gallon drum of waste is a highlight and one of the only things that marks civilized time.

--- Down here, each action requires 1 energy point. And without energy, your health will decrease 11 points per action. ---

You can see a tent (empty) and 'Basecamp Chest' (in which are an orange, a cliff bar, beef jerky, chicken jerky, a water bottle, an ice axe, crampons, a rope, a first aid kit and a chemical warming pack) here.

Current Load: 20%    Max Load: 100%            Energy: 99%    Health: 100%

>take tent
Taken.

Current Load: 40%    Max Load: 100%            Energy: 98%    Health: 100%

* * *

>take tent
Taken.

Current Load: 20%    Max Load: 100%            Energy: 98%    Health: 100%

>take backpack
Taken.

Current Load: 0%    Max Load: 100%            Energy: 97%    Health: 100%

>take tent
You're carrying too many things already.

Current Load: 0%    Max Load: 100%            Energy: 96%    Health: 100%

>wear backpack
You put on the backpack.

Current Load: 0%    Max Load: 100%            Energy: 95%    Health: 100%

>take tent
Taken.

Current Load: 0%    Max Load: 100%            Energy: 94%    Health: 100%

>take all
water bottle: (putting the tent into the backpack to make room)
Taken.
ice axe: (putting the water bottle into the backpack to make room)
Taken.
orange: (putting the ice axe into the backpack to make room)
Taken.

Current Load: 0%    Max Load: 100%            Energy: 93%    Health: 100%

* * *

>take tent
Taken.

Current Load: 20%    Max Load: 100%            Energy: 98%    Health: 100%

>take bottle
Taken.

Load: 0%  Energy: 97%  Health: 100%

>take axe
Well, both of your hands are full now... you can carry more after dropping something and wearing a backpack.

Load: 0%  Energy: 96%  Health: 100%

>i
You are carrying:
  a water bottle
  a tent

Load: 0%  Energy: 95%  Health: 100%

>drop axe
You haven't got that.

Load: 0%  Energy: 94%  Health: 100%

>drop bottle
Dropped.

Load: 0%  Energy: 93%  Health: 100%

>wear backpack
(first taking the backpack)
You put on the backpack.

Load: 0%  Energy: 92%  Health: 100%

* * *

>open chest
You open 'Basecamp Chest', revealing an orange, a cliff bar, beef jerky, chicken jerky, a water bottle, an ice axe, crampons, a rope, a first aid kit, a tent and a chemical warming pack.

Current Load: 0%    Max Load: 100%            Energy: 99%    Health: 100%

>take water
Try taking things once you're wearing a backpack. You can hold a lot more that way, but remember, the higher up you go the less you'll be able to carry.

Current Load: 0%    Max Load: 0%            Energy: 98%    Health: 100%

>wear backpack
(first taking the backpack)
You're now wearing a backpack.

You're already wearing that!

Current Load: 0%    Max Load: 100%            Energy: 97%    Health: 100%

* * *

>open chest
You open 'Basecamp Chest', revealing an orange, a cliff bar, beef jerky, chicken jerky, a water bottle, an ice axe, crampons, a rope, a first aid kit, a tent and a chemical warming pack.

Current Load: 0%    Max Load: 100%            Energy: 99%    Health: 100%

>take water bottle
Load: 0%  Energy: 98%  Health: 100%

>take axe
Load: 0%  Energy: 97%  Health: 100%

>take tent
Load: 0%  Energy: 96%  Health: 100%

>take orange
Load: 0%  Energy: 95%  Health: 100%

>i
You are carrying nothing.

Load: 0%  Energy: 94%  Health: 100%

* * *

>open chest
You open 'Basecamp Chest', revealing an orange, a cliff bar, beef jerky, chicken jerky, a water bottle, an ice axe, crampons, a rope, a first aid kit, a tent and a chemical warming pack.

Current Load: 0%    Max Load: 100%            Energy: 99%    Health: 100%

>take water, chicken, axe, tent
water bottle: Taken.
chicken jerky: Taken.
ice axe: Taken.
tent: Taken.

Current Load: 60%    Max Load: 100%            Energy: 98%    Health: 100%

>eat orange
(first taking the orange)
Your energy has increased a bit.

Current Load: 63%    Max Load: 100%            Energy: 100%    Health: 100%

>go n
Are you sure you want to go to Camp1? This hike will require 20 energy.

>y
You make the trek to Camp1 and arrive late in the evening.

Camp1
Camp 1 (4900m)  At 16,076 feet above sea level, Camp 1 is higher than most people have every climbed. It is higher than any peak in North America. It is just 1000 feet lower than Everest Base Camp in Nepal. Camp 1 is located at the top of the trail on a plateau. Aconcagua is not visible from here, but its sister, Mt. Ameguino's snowy peak looms above you. The camp is located several hundred meters from the glacial stream. There is no outhouse (you must bury your waste, away from any area that could contaminate the stream). Carrying water from the stream to boil for hydration and cooking is required. You can only carry part of what you need to Camp 1 on your first trip, so you must plan carefully. Climbers stay one night in Camp 1, then return to Base Camp for more supplies. You have to bring the bare essentials - tent, sleeping bag, camp stove, food. You don't immediately need ice climbing equipment - mountaineering boots, crampons, ice ax, harness, helmet, rope. But you will eventually need to bring up to Camp 1, as it's needed at higher elevations.

--- Here, each action requires 2 energy points. And without energy, your health will decrease 12 points per action. ---

Current Load: 63%    Max Load: 100%            Energy: 78%    Health: 100%

>go s
It's dark out, and you need some sleep before making another trek.

Current Load: 63%    Max Load: 100%            Energy: 76%    Health: 100%

>sleep
Sleeping outdoors is a bad idea - it's freezing! You should find shelter but it's totally up to you. Are you sure you want to sleep here?

>y
You close your eyes... and suffer through a freezing night. Finally, you awake the next day at the crack of dawn.

You got some sleep, but it's pretty cold even down here. You're 10% more tired than before.

Current Load: 63%    Max Load: 100%            Energy: 64%    Health: 100%

>go s
Are you sure you want to go to Basecamp? This hike will require 15 energy.

>y
You make the trek to Basecamp and arrive late in the evening.

Basecamp
Plaza Argentina Base Camp (4200m) for Mt. Aconcagua. The trail up to the summit begins here. It's a dangerous, but non-technical climb. There is a collection of ragtag temporary structures that form the Guardia's seasonal presence at the less popular Polish Route base camp. Brightly colored tents dot the plateau. The Polish Glacier looms in the distance, and a swift stream - the headwaters of the Vacas river flow from its base. There is an outhouse on the edge of camp. The weekly helicopter retrieval of the 50 gallon drum of waste is a highlight and one of the only things that marks civilized time.

--- Down here, each action requires 1 energy point. And without energy, your health will decrease 11 points per action. ---

You can see 'Basecamp Chest' (in which are a cliff bar, beef jerky, crampons, a rope and a chemical warming pack) here.

Current Load: 63%    Max Load: 100%            Energy: 48%    Health: 100%

>go n
It's dark out, and you need some sleep before making another trek.

Current Load: 63%    Max Load: 100%            Energy: 47%    Health: 100%

* * *

>open chest
You open 'Basecamp Chest', revealing an orange, a cliff bar, beef jerky, chicken jerky, a water bottle, an ice axe, crampons, a rope, a first aid kit, a tent and a chemical warming pack.

Current Load: 0%    Max Load: 100%            Energy: 99%    Health: 100%

>take water, chicken, beef, rope first aid kit, tent, axe
I only understood you as far as wanting to take those things.

* * *

>open chest
You open 'Basecamp Chest', revealing an orange, a cliff bar, beef jerky, chicken jerky, a water bottle, an ice axe, crampons, a rope, a first aid kit, a tent and a chemical warming pack.

Current Load: 0%    Max Load: 100%            Energy: 99%    Health: 100%

>take water, chicken, beef, rope, first aid kit, tent, axe
water bottle: Taken.
chicken jerky: Taken.
beef jerky: Taken.
rope: Taken.
first aid kit: Taken.
tent: Taken.
ice axe: Taken.

Current Load: 90%    Max Load: 100%            Energy: 98%    Health: 100%

>eat orange
(first taking the orange)
Your energy has increased a bit.

Current Load: 90%    Max Load: 100%            Energy: 99%    Health: 100%

>go n
Are you sure you want to go to Camp1? This hike will require 20 energy.

>y
You make the trek to Camp1 and arrive late in the evening.

Camp1
Camp 1 (4900m)  At 16,076 feet above sea level, Camp 1 is higher than most people have every climbed. It is higher than any peak in North America. It is just 1000 feet lower than Everest Base Camp in Nepal. Camp 1 is located at the top of the trail on a plateau. Aconcagua is not visible from here, but its sister, Mt. Ameguino's snowy peak looms above you. The camp is located several hundred meters from the glacial stream. There is no outhouse (you must bury your waste, away from any area that could contaminate the stream).

--- Here, each action requires 2 energy points. And without energy, your health will decrease 12 points per action. ---

Immediately ahead, you see the glacier blocking your path... good thing you brought climbing gear... right?

Current Load: 90%    Max Load: 100%            Energy: 77%    Health: 100%

>drop tent
Dropped.

Current Load: 70%    Max Load: 100%            Energy: 75%    Health: 100%

>enter tent
You enter the tent. It's nice and cozy inside.

Current Load: 70%    Max Load: 100%            Energy: 75%    Health: 100%

>sleep
You close your eyes... and awake the next day at the crack of dawn.

You're rested and ready to continue. Your energy has increased by 20%.

Current Load: 70%    Max Load: 100%            Energy: 95%    Health: 100%

>get out
You get out of the tent.

Camp1
Camp 1 (4900m)  At 16,076 feet above sea level, Camp 1 is higher than most people have every climbed. It is higher than any peak in North America. It is just 1000 feet lower than Everest Base Camp in Nepal. Camp 1 is located at the top of the trail on a plateau. Aconcagua is not visible from here, but its sister, Mt. Ameguino's snowy peak looms above you. The camp is located several hundred meters from the glacial stream. There is no outhouse (you must bury your waste, away from any area that could contaminate the stream).

--- Here, each action requires 2 energy points. And without energy, your health will decrease 12 points per action. ---

You can see a tent (empty) here.

Current Load: 70%    Max Load: 100%            Energy: 93%    Health: 100%

>take tent
Taken.

Current Load: 90%    Max Load: 100%            Energy: 91%    Health: 100%

>drop chicken
Dropped.

Current Load: 80%    Max Load: 100%            Energy: 89%    Health: 100%

>drop first aid kit
Dropped.

Current Load: 70%    Max Load: 100%            Energy: 87%    Health: 100%

>go n
Are you sure you want to go to Camp2? A glacier is blocking the path and there's no way around it... there's a 60% chance of success without a fall, plus the total 25% bonus of your climbing gear. The climb will require 30% energy and a fall would reduce your health by 40%.

>y
You begin the climb to Camp2.

You climb, climb, and climb.

Your limbs want to give up - but you won't let them.

Aside from a few near death experiences, you finally make it to the top!

By now, it's night. 
Camp2
Camp 2 (5850m) Camp 2 is located just above most of the Polish Glacier. Below, it appears as a both a wall and a river of blue-green ice and white pillars. These are Los Penitentes, statues in ice guarding the glacier. From here, you can see all the way to the Valle de Vacas. Up here it's noticeably colder and much windier, but still manageable.

--- At this altitude, each action requires 5 energy points. And without energy, your health will decrease 15 points per action. ---

Beware, you cannot camp in Camp3.

Current Load: 70%    Max Load: 100%            Energy: 52%    Health: 100%

>drop tent
Dropped.

Current Load: 50%    Max Load: 100%            Energy: 47%    Health: 100%

>enter tent
You enter the tent. It's nice and cozy inside.

Current Load: 50%    Max Load: 100%            Energy: 47%    Health: 100%

>sleep
You close your eyes... and awake the next day at the crack of dawn.

You're rested and ready to continue. Your energy has increased by 20%.

Current Load: 50%    Max Load: 100%            Energy: 67%    Health: 100%

>drop axe
Dropped.

Current Load: 35%    Max Load: 100%            Energy: 67%    Health: 100%

>drop rope
Dropped.

Current Load: 25%    Max Load: 100%            Energy: 67%    Health: 100%

>get out
You get out of the tent.

Camp2
Camp 2 (5850m) Camp 2 is located just above most of the Polish Glacier. Below, it appears as a both a wall and a river of blue-green ice and white pillars. These are Los Penitentes, statues in ice guarding the glacier. From here, you can see all the way to the Valle de Vacas. Up here it's noticeably colder and much windier, but still manageable.

--- At this altitude, each action requires 5 energy points. And without energy, your health will decrease 15 points per action. ---

You can see a tent (in which are a rope and an ice axe) here.

Current Load: 25%    Max Load: 100%            Energy: 62%    Health: 100%

>sip water
Aaaaahh! Very refreshing. Only 6 sips left.

Current Load: 25%    Max Load: 100%            Energy: 72%    Health: 100%

>sip water
Aaaaahh! Very refreshing. Only 5 sips left.

Current Load: 25%    Max Load: 100%            Energy: 82%    Health: 100%

>sip water
Aaaaahh! Very refreshing. Only 4 sips left.

Current Load: 25%    Max Load: 100%            Energy: 92%    Health: 100%

>go n
Are you sure you want to go to Camp3? This hike will require 30 energy.

>y
You make the trek to Camp3.

Camp3
Camp 3 (400m elevation gain). No one stays in Camp 3 for long. It is above the "kill zone" where lack of oxygen and hypoxia can cause rapid deterioration in your mental and physical state. If you decide to use Camp 3, it's only for a quick stop over so you can be fueled to attempt the summit. You usually only take the bare essentials: a source of energy and warmth. If you survive the summit, you will only stop back here to retrieve your equipment - but that's a BIG if.

--- Way up here, each action requires 10 energy points. And without energy, your health will decrease 20 points per action. ---

Don't give up, you're almost there!

Current Load: 25%    Max Load: 100%            Energy: 52%    Health: 100%

>drop beef
Dropped.

Current Load: 15%    Max Load: 100%            Energy: 42%    Health: 100%

>go n
Are you sure you want to go to Summit? This hike will require 40 energy.

>y
Finally, you continue the trek to the Summit.

Summit
Summit (6962m). The summit of Aconcagua is unremarkable in some ways. It's a rocky outcropping with various markers, cairns and flags placed there by other climbers. You pause, but not for too long, for photographs and to congratulate members of your team for the accomplishment. You know that you are on the highest peak anywhere except for the Himalayas. Now, you must descend before the weather turns or you lose your mind from lack of oxygen.

--- At the top, each action requires 10 energy points. And without energy, your health will decrease 20 points per action. ---

Woohoooo! You made it to the summit alive! well mostly... Now, you just have to do it all over again in reverse ;)

Current Load: 15%    Max Load: 100%            Energy: 0%    Health: 80%

Your energy is low! You need food, water, or rest (probably all three).

>drink water
Aaaaahh! Very refreshing. Only 3 sips left.

Current Load: 15%    Max Load: 100%            Energy: 5%    Health: 80%

>drink
(the water bottle)
Aaaaahh! Very refreshing. Only 2 sips left.

Current Load: 15%    Max Load: 100%            Energy: 10%    Health: 80%

>undo
Summit
[Previous turn undone.]

>undo
Summit
[Previous turn undone.]

>go s
Are you sure you want to go to back to Camp3? This hike will require 40 energy.

>y
Making it to the Summit is only half the battle - you begin the descent.

Camp3
Camp 3 (400m elevation gain). No one stays in Camp 3 for long. It is above the "kill zone" where lack of oxygen and hypoxia can cause rapid deterioration in your mental and physical state. If you decide to use Camp 3, it's only for a quick stop over so you can be fueled to attempt the summit. You usually only take the bare essentials: a source of energy and warmth. If you survive the summit, you will only stop back here to retrieve your equipment - but that's a BIG if.

--- Way up here, each action requires 10 energy points. And without energy, your health will decrease 20 points per action. ---

You can see beef jerky here.

Current Load: 15%    Max Load: 100%            Energy: 0%    Health: 60%

>eat beef
(first taking beef jerky)
Your energy has increased a bit.

Current Load: 15%    Max Load: 100%            Energy: 25%    Health: 60%

>go s
Are you sure you want to go to Camp2? This hike will require 25 energy.

>y
You make the trek to Camp2.

Camp2
Camp 2 (5850m) Camp 2 is located just above most of the Polish Glacier. Below, it appears as a both a wall and a river of blue-green ice and white pillars. These are Los Penitentes, statues in ice guarding the glacier. From here, you can see all the way to the Valle de Vacas. Up here it's noticeably colder and much windier, but still manageable.

--- At this altitude, each action requires 5 energy points. And without energy, your health will decrease 15 points per action. ---

You can see a tent (in which are a rope and an ice axe) here.

Current Load: 15%    Max Load: 100%            Energy: 0%    Health: 45%

>enter tent
You enter the tent. It's nice and cozy inside.

Current Load: 15%    Max Load: 100%            Energy: 0%    Health: 45%

>sleep
You close your eyes... and awake the next day at the crack of dawn.

You're rested and ready to continue. Your energy has increased by 20%.

Current Load: 15%    Max Load: 100%            Energy: 20%    Health: 45%

>take rope, axe
rope: Taken.
ice axe: Taken.

Current Load: 40%    Max Load: 100%            Energy: 20%    Health: 45%

>get out
You get out of the tent.

Camp2
Camp 2 (5850m) Camp 2 is located just above most of the Polish Glacier. Below, it appears as a both a wall and a river of blue-green ice and white pillars. These are Los Penitentes, statues in ice guarding the glacier. From here, you can see all the way to the Valle de Vacas. Up here it's noticeably colder and much windier, but still manageable.

--- At this altitude, each action requires 5 energy points. And without energy, your health will decrease 15 points per action. ---

You can see a tent (empty) here.

Current Load: 40%    Max Load: 100%            Energy: 15%    Health: 45%

>take tent
Taken.

Current Load: 60%    Max Load: 100%            Energy: 10%    Health: 45%

>sip
What do you want to sip?

>drink water
Aaaaahh! Very refreshing. Only 3 sips left.

Current Load: 60%    Max Load: 100%            Energy: 20%    Health: 45%

>drink water
Aaaaahh! Very refreshing. Only 2 sips left.

Current Load: 60%    Max Load: 100%            Energy: 30%    Health: 45%

>drink water
Aaaaahh! Very refreshing. Only 1 sips left.

Current Load: 60%    Max Load: 100%            Energy: 40%    Health: 45%

>go s
Are you sure you want to go to Camp1? You'll have to climb back down the glacier... there's a 35% chance of success without a fall, plus the total 25% bonus of your climbing gear. The climb will require 30% energy and a fall would reduce your health by 40%.

>y
You begin the climb to Camp1.

You climb, climb, and climb.

Your limbs want to give up - but you won't let them.

Aside from a few near death experiences, you finally make it down!

Camp1
Camp 1 (4900m)  At 16,076 feet above sea level, Camp 1 is higher than most people have every climbed. It is higher than any peak in North America. It is just 1000 feet lower than Everest Base Camp in Nepal. Camp 1 is located at the top of the trail on a plateau. Aconcagua is not visible from here, but its sister, Mt. Ameguino's snowy peak looms above you. The camp is located several hundred meters from the glacial stream. There is no outhouse (you must bury your waste, away from any area that could contaminate the stream).

--- Here, each action requires 2 energy points. And without energy, your health will decrease 12 points per action. ---

You can see a first aid kit and chicken jerky here.

Current Load: 60%    Max Load: 100%            Energy: 8%    Health: 45%

>eat chicken
(first taking chicken jerky)
Your energy has increased a bit.

Current Load: 60%    Max Load: 100%            Energy: 41%    Health: 45%

>drop tent
Dropped.

Current Load: 40%    Max Load: 100%            Energy: 39%    Health: 45%

>enter tent
You enter the tent. It's nice and cozy inside.

Current Load: 40%    Max Load: 100%            Energy: 39%    Health: 45%

>sleep
You close your eyes... and awake the next day at the crack of dawn.

You're rested and ready to continue. Your energy has increased by 20%.

Current Load: 40%    Max Load: 100%            Energy: 59%    Health: 45%

>get out
You get out of the tent.

Camp1
Camp 1 (4900m)  At 16,076 feet above sea level, Camp 1 is higher than most people have every climbed. It is higher than any peak in North America. It is just 1000 feet lower than Everest Base Camp in Nepal. Camp 1 is located at the top of the trail on a plateau. Aconcagua is not visible from here, but its sister, Mt. Ameguino's snowy peak looms above you. The camp is located several hundred meters from the glacial stream. There is no outhouse (you must bury your waste, away from any area that could contaminate the stream).

--- Here, each action requires 2 energy points. And without energy, your health will decrease 12 points per action. ---

You can see a tent (empty) and a first aid kit here.

Current Load: 40%    Max Load: 100%            Energy: 57%    Health: 45%

>use first aid kit
Your health has increased a bit.

Current Load: 40%    Max Load: 100%            Energy: 55%    Health: 75%

>take tent
Taken.

Current Load: 60%    Max Load: 100%            Energy: 53%    Health: 75%

>go s
Are you sure you want to go to Basecamp? This hike will require 15 energy.

>y
Weak legged and freezing, you make the last trek of the journey and arrive late in the evening.

Basecamp
Plaza Argentina Base Camp (4200m) for Mt. Aconcagua. The trail up to the summit begins here. It's a dangerous, but non-technical climb. There is a collection of ragtag temporary structures that form the Guardia's seasonal presence at the less popular Polish Route base camp. Brightly colored tents dot the plateau. The Polish Glacier looms in the distance, and a swift stream - the headwaters of the Vacas river flow from its base. There is an outhouse on the edge of camp. The weekly helicopter retrieval of the 50 gallon drum of waste is a highlight and one of the only things that marks civilized time.

Use your map to help you decide what supplies you should take on your ascent.

--- Down here, each action requires 1 energy point. And without energy, your health will decrease 11 points per action. ---

You can see 'Basecamp Chest' (in which are a cliff bar, crampons and a chemical warming pack) here.

    *** Congratulations! You made it to the Summit AND survived to tell the tale. ***

Would you like to RESTART, RESTORE a saved game, QUIT or UNDO the last command?

* * *

>i
You are carrying:
  beef jerky
  a water bottle

Current Load: 25%    Max Load: 100%            Energy: 75%    Health: 100%

>undo
Camp3
[Previous turn undone.]

>drop beef
Dropped.

Current Load: 15%    Max Load: 100%            Energy: 75%    Health: 100%

>go n
Are you sure you want to go to Summit? This hike will require 40 energy.

>y
Finally, you continue the trek to the Summit.

Summit
Summit (6962m). The summit of Aconcagua is unremarkable in some ways. It's a rocky outcropping with various markers, cairns and flags placed there by other climbers. You pause, but not for too long, for photographs and to congratulate members of your team for the accomplishment. You know that you are on the highest peak anywhere except for the Himalayas. Now, you must descend before the weather turns or you lose your mind from lack of oxygen.

--- At the top, each action requires 10 energy points. And without energy, your health will decrease 20 points per action. ---

Current Load: 15%    Max Load: 100%            Energy: 65%    Health: 100%

>go s
Are you sure you want to go to back to Camp3? This hike will require 40 energy.

>y
Making it to the Summit is only half the battle - you begin the descent.

Camp3
Camp 3 (400m elevation gain). No one stays in Camp 3 for long. It is above the "kill zone" where lack of oxygen and hypoxia can cause rapid deterioration in your mental and physical state. If you decide to use Camp 3, it's only for a quick stop over so you can be up well before sunrise to attempt the summit. You take only the bare essentials: shelter, food, safety equipment, and your climbing gear. You leave your tent and sleeping bag behind, but you won't be staying at Camp 3 after the summit. You will stop to retrieve your equipment, if you survive the summit, but that's it. If you choose to summit from Camp 3, you will have less climbing to do, but you will also be weaker from the extra time at altitude.

--- Way up here, each action requires 10 energy points. And without energy, your health will decrease 20 points per action. ---

You can see beef jerky here.

Current Load: 15%    Max Load: 100%            Energy: 55%    Health: 100%

>eat beef
(first taking beef jerky)
Your energy has increased a bit.

Current Load: 15%    Max Load: 100%            Energy: 70%    Health: 100%

>go s
Are you sure you want to go to Camp2? This hike will require 25 energy.

>y
You make the trek to Camp2.

Camp2
Camp 2 (5850m) Camp 2 is located at the base of visible portions of the Polish Glacier. Below, it retreats under the moraine, but above you, it appears as a both a wall and a river of blue-green ice and white pillars. These are Los Penitentes, statues in ice guarding the glacier. From here, you can see all the way to the Valle de Vacas. Just like with portages from Plaza Argentina to Camp 1, you must make several trips over 3 days from Camp 1 to Camp 2 to haul the rest of your gear. You leave almost nothing behind at Camp 1, except for an emergency shelter tent and some provisions. You have the option of stashing extra water and saving some of your favorite food for the descent.

--- At this altitude, each action requires 5 energy points. And without energy, your health will decrease 15 points per action. ---

You can see a tent (in which are a rope and an ice axe) here.

Current Load: 15%    Max Load: 100%            Energy: 65%    Health: 100%

>take rope, axe
rope: Taken.
ice axe: Taken.

Current Load: 40%    Max Load: 100%            Energy: 60%    Health: 100%

>go s
It's dark out, and you need some sleep before making another trek.

Current Load: 40%    Max Load: 100%            Energy: 55%    Health: 100%

>undo
Camp2
[Previous turn undone.]

>undo
Camp2
[Previous turn undone.]

>enter tent
You enter the tent. It's nice and cozy inside.

Current Load: 15%    Max Load: 100%            Energy: 85%    Health: 100%

>sleep
You close your eyes... and awake the next day at the crack of dawn.

You're rested and ready to continue. Your energy has increased by 20%.

Current Load: 15%    Max Load: 100%            Energy: 100%    Health: 100%

>get out
You get out of the tent.

Camp2
Camp 2 (5850m) Camp 2 is located at the base of visible portions of the Polish Glacier. Below, it retreats under the moraine, but above you, it appears as a both a wall and a river of blue-green ice and white pillars. These are Los Penitentes, statues in ice guarding the glacier. From here, you can see all the way to the Valle de Vacas. Just like with portages from Plaza Argentina to Camp 1, you must make several trips over 3 days from Camp 1 to Camp 2 to haul the rest of your gear. You leave almost nothing behind at Camp 1, except for an emergency shelter tent and some provisions. You have the option of stashing extra water and saving some of your favorite food for the descent.

--- At this altitude, each action requires 5 energy points. And without energy, your health will decrease 15 points per action. ---

You can see a tent (in which are a rope and an ice axe) here.

Current Load: 15%    Max Load: 100%            Energy: 95%    Health: 100%

>take rope, axe
rope: Taken.
ice axe: Taken.

Current Load: 40%    Max Load: 100%            Energy: 90%    Health: 100%

>go s
Are you sure you want to go to Camp1? You'll have to climb back down the glacier... there's a 35% chance of success without a fall, plus the total 30% bonus of your climbing gear. The climb will require 60 energy and a fall would reduce your health by 40%.

>y
You begin the climb to Camp1.

You climb, climb, and climb.

Your limbs want to give up - but you won't let them.

Aside from a few near death experiences, you finally make it to the top!

Camp1
Camp 1 (4900m)  At 16,076 feet above sea level, Camp 1 is higher than most people have every climbed. It is higher than any peak in North America. It is just 1000 feet lower than Everest Base Camp in Nepal. Camp 1 is located at the top of the trail on a plateau. Aconcagua is not visible from here, but its sister, Mt. Ameguino's snowy peak looms above you. The camp is located several hundred meters from the glacial stream. There is no outhouse (you must bury your waste, away from any area that could contaminate the stream). You can only carry part of what you need to Camp 2 on your first trip, so you must plan carefully. Climbers normally stay one night in Camp 1, then return to Basecamp for more supplies. The Polish Glacier is between here and Camp 2, so you'll need an ice axe to climb it.

--- Here, each action requires 2 energy points. And without energy, your health will decrease 12 points per action. ---

You can see a first aid kit and chicken jerky here.

Current Load: 40%    Max Load: 100%            Energy: 58%    Health: 100%

>eat chicken
(first taking chicken jerky)
Your energy has increased a bit.

Current Load: 40%    Max Load: 100%            Energy: 81%    Health: 100%

>go s
It's dark out, and you need some sleep before making another trek.

Current Load: 40%    Max Load: 100%            Energy: 79%    Health: 100%

* * *

>use first aid kit
Your health has increased a bit.

Current Load: 70%    Max Load: 100%            Energy: 58%    Health: 90%

>eat chicken
(first taking chicken jerky)
Your energy has increased a bit.

Current Load: 70%    Max Load: 100%            Energy: 81%    Health: 90%

>drop tent
Dropped.

Current Load: 50%    Max Load: 100%            Energy: 79%    Health: 90%

>enter tent
You enter the tent. It's nice and cozy inside.

Current Load: 50%    Max Load: 100%            Energy: 99%    Health: 90%

>sleep
There's no more time for rest, you've got some hiking to do.

Current Load: 50%    Max Load: 100%            Energy: 99%    Health: 90%

>map
That's not a verb I recognise.

* * *

>take tent
Taken.

Current Load: 90%    Max Load: 100%            Energy: 91%    Health: 100%

>go n
You won't be able to carry all that up there because your max load at Camp2 is only 75%. You have to drop some items (though you can always come back for them).

Current Load: 95%    Max Load: 100%            Energy: 94%    Health: 100%

>drop chicken
Dropped.

Current Load: 85%    Max Load: 100%            Energy: 92%    Health: 100%

>drop first aid kit
Dropped.

Current Load: 70%    Max Load: 100%            Energy: 90%    Health: 100%

>go n
Are you sure you want to go to Camp2? A glacier is blocking the path and there's no way around it... there's a 60% chance of success without a fall, plus the total 30% bonus of your climbing gear. The climb will require 30 energy and a fall would reduce your health by 40%.

>y
You begin the climb to Camp2.

You climb, climb, and climb.

Your limbs want to give up - but you won't let them.

Aside from a few near death experiences, you finally make it to the top!

By now, it's night. 
Camp2
Camp 2 (5850m) Camp 2 is located at the base of visible portions of the Polish Glacier. Below, it retreats under the moraine, but above you, it appears as a both a wall and a river of blue-green ice and white pillars. These are Los Penitentes, statues in ice guarding the glacier. From here, you can see all the way to the Valle de Vacas. Just like with portages from Plaza Argentina to Camp 1, you must make several trips over 3 days from Camp 1 to Camp 2 to haul the rest of your gear. You leave almost nothing behind at Camp 1, except for an emergency shelter tent and some provisions. You have the option of stashing extra water and saving some of your favorite food for the descent.

--- At this altitude, each action requires 5 energy points. And without energy, your health will decrease 15 points per action. ---

Current Load: 70%    Max Load: 100%            Energy: 55%    Health: 100%

>drop tent
Dropped.

Current Load: 50%    Max Load: 100%            Energy: 50%    Health: 100%

>sleep
Sleeping outdoors is a bad idea - it's freezing! You should find shelter but it's totally up to you. Are you sure you want to sleep here?

>n
Current Load: 50%    Max Load: 100%            Energy: 45%    Health: 100%

>enter tent
You enter the tent. It's nice and cozy inside.

Current Load: 50%    Max Load: 100%            Energy: 65%    Health: 100%

>sleep
You close your eyes... and awake the next day at the crack of dawn.

You're rested and ready to continue. Your energy has increased by 20%.

Current Load: 50%    Max Load: 100%            Energy: 85%    Health: 100%

>i
You are carrying:
  an ice axe
  a rope
  beef jerky
  a water bottle

Current Load: 50%    Max Load: 100%            Energy: 85%    Health: 100%

>drop axe
Dropped.

Current Load: 35%    Max Load: 100%            Energy: 85%    Health: 100%

>drop rope
Dropped.

Current Load: 25%    Max Load: 100%            Energy: 85%    Health: 100%

>get out
You get out of the tent.

Camp2
Camp 2 (5850m) Camp 2 is located at the base of visible portions of the Polish Glacier. Below, it retreats under the moraine, but above you, it appears as a both a wall and a river of blue-green ice and white pillars. These are Los Penitentes, statues in ice guarding the glacier. From here, you can see all the way to the Valle de Vacas. Just like with portages from Plaza Argentina to Camp 1, you must make several trips over 3 days from Camp 1 to Camp 2 to haul the rest of your gear. You leave almost nothing behind at Camp 1, except for an emergency shelter tent and some provisions. You have the option of stashing extra water and saving some of your favorite food for the descent.

--- At this altitude, each action requires 5 energy points. And without energy, your health will decrease 15 points per action. ---

You can see a tent (in which are a rope and an ice axe) here.

Current Load: 25%    Max Load: 100%            Energy: 80%    Health: 100%

>sip water
Aaaaahh! Very refreshing. Only 6 sips left.

Current Load: 25%    Max Load: 100%            Energy: 85%    Health: 100%

>sip water
Aaaaahh! Very refreshing. Only 5 sips left.

Current Load: 25%    Max Load: 100%            Energy: 90%    Health: 100%

>sip water
Aaaaahh! Very refreshing. Only 4 sips left.

Current Load: 25%    Max Load: 100%            Energy: 95%    Health: 100%

>sip water
Aaaaahh! Very refreshing. Only 3 sips left.

Current Load: 25%    Max Load: 100%            Energy: 95%    Health: 100%

>go n
Are you sure you want to go to Camp3? This hike will require 30 energy.

>y
You make the trek to Camp3.

Camp3
Camp 3 (400m elevation gain). No one stays in Camp 3 for long. It is above the "kill zone" where lack of oxygen and hypoxia can cause rapid deterioration in your mental and physical state. If you decide to use Camp 3, it's only for a quick stop over so you can be up well before sunrise to attempt the summit. You take only the bare essentials: shelter, food, safety equipment, and your climbing gear. You leave your tent and sleeping bag behind, but you won't be staying at Camp 3 after the summit. You will stop to retrieve your equipment, if you survive the summit, but that's it. If you choose to summit from Camp 3, you will have less climbing to do, but you will also be weaker from the extra time at altitude.

--- Way up here, each action requires 10 energy points. And without energy, your health will decrease 20 points per action. ---

Current Load: 25%    Max Load: 100%            Energy: 85%    Health: 100%

>go n
You won't be able to carry all that up there because your max load at the Summit is a mere 15%. You have to drop some items (though you can always come back for them).

Current Load: 25%    Max Load: 100%            Energy: 75%    Health: 100%

* * *

>open chest
You open 'Basecamp Chest', revealing an orange, a cliff bar, beef jerky, chicken jerky, a water bottle, an ice axe, crampons, a rope, a first aid kit, a tent and a chemical warming pack.

Current Load: 0%    Max Load: 100%            Energy: 99%    Health: 100%

>take water, cliff, chicken, beef, rope, first aid kit, tent
water bottle: Taken.
cliff bar: Taken.
chicken jerky: Taken.
beef jerky: Taken.
rope: Taken.
first aid kit: Taken.
tent: Taken.

Current Load: 86%    Max Load: 100%            Energy: 98%    Health: 100%

>eat orange
(first taking the orange)
Your energy has increased a bit.

Current Load: 86%    Max Load: 100%            Energy: 99%    Health: 100%

>go n
Before heading up to Camp1, you should at least bring food, water, shelter, and an ice axe.

Current Load: 86%    Max Load: 100%            Energy: 98%    Health: 100%

* * *

>open chest
You open 'Basecamp Chest', revealing an orange, a cliff bar, beef jerky, chicken jerky, a water bottle, an ice axe, crampons, a rope, a first aid kit, a tent and a chemical warming pack.

Current Load: 0%    Max Load: 100%            Energy: 99%    Health: 100%

>take water, cliff, chicken, beef, rope, first aid kit, tent, axe
water bottle: Taken.
cliff bar: Taken.
chicken jerky: Taken.
beef jerky: Taken.
rope: Taken.
first aid kit: Taken.
tent: Taken.
ice axe: You're at max capacity. At this elevation you're max load is 100% and you're currently holding 86%, but this item requires an additional 15%.

Current Load: 86%    Max Load: 100%            Energy: 98%    Health: 100%

* * *

>open chest
You open 'Basecamp Chest', revealing an orange, a cliff bar, beef jerky, chicken jerky, a water bottle, an ice axe, crampons, a rope, a first aid kit, a tent and a chemical warming pack.

Current Load: 0%    Max Load: 100%            Energy: 99%    Health: 100%

>wear backpack
(first taking the backpack)
You put on the backpack.

Current Load: 0%    Max Load: 100%            Energy: 98%    Health: 100%

>take all
orange: Taken.
cliff bar: (putting the orange into the backpack to make room)
Taken.
small pack of jerky: (putting the cliff bar into the backpack to make room)
Taken.
water bottle: (putting the small pack of jerky into the backpack to make room)
Taken.
ice axe: (putting the water bottle into the backpack to make room)
Taken.
crampons: (putting the ice axe into the backpack to make room)
Taken.
rope: (putting crampons into the backpack to make room)
Taken.
tent: (putting the rope into the backpack to make room)
Taken.
chemical warming pack: (putting the tent into the backpack to make room)
Taken.

Current Load: 99%    Max Load: 100%            Energy: 97%    Health: 100%

>eat orange
(first taking the orange)
You're at max capacity. At this elevation you're max load is 100% and you're currently holding 99%, but this item requires an additional 3%.

Current Load: 99%    Max Load: 100%            Energy: 96%    Health: 100%

>i
You are carrying:
  a chemical warming pack
  a backpack (being worn and open)
    a tent
    a rope
    crampons
    an ice axe
    a water bottle
    a small pack of jerky
    a cliff bar
    an orange

Current Load: 99%    Max Load: 100%            Energy: 95%    Health: 100%

>eat orange
(first taking the orange)
You're at max capacity. At this elevation you're max load is 100% and you're currently holding 99%, but this item requires an additional 3%.

Current Load: 99%    Max Load: 100%            Energy: 94%    Health: 100%

>i
You are carrying:
  a chemical warming pack
  a backpack (being worn and open)
    a tent
    a rope
    crampons
    an ice axe
    a water bottle
    a small pack of jerky
    a cliff bar
    an orange

Current Load: 99%    Max Load: 100%            Energy: 93%    Health: 100%

>take orange
You're at max capacity. At this elevation you're max load is 100% and you're currently holding 99%, but this item requires an additional 3%.

Current Load: 99%    Max Load: 100%            Energy: 92%    Health: 100%

>drop rope
You haven't got that.

Current Load: 89%    Max Load: 100%            Energy: 91%    Health: 100%

>take tent
You're at max capacity. At this elevation you're max load is 100% and you're currently holding 89%, but this item requires an additional 20%.

Current Load: 89%    Max Load: 100%            Energy: 90%    Health: 100%

* * *

>wear backpack
(first taking the backpack)
You put on the backpack.

Current Load: 0%    Max Load: 100%            Energy: 98%    Health: 100%

>take tent
Taken.

Current Load: 20%    Max Load: 100%            Energy: 97%    Health: 100%

>take bottle
(putting the tent into the backpack to make room)
Taken.

Current Load: 35%    Max Load: 100%            Energy: 96%    Health: 100%

>take all
ice axe: (putting the water bottle into the backpack to make room)
Taken.
orange: (putting the ice axe into the backpack to make room)
Taken.

Current Load: 53%    Max Load: 100%            Energy: 95%    Health: 100%

* * *

>wear backpack
(first taking the backpack)
You put on the backpack.

Current Load: 0%    Max Load: 100%            Energy: 98%    Health: 100%

>undo
Basecamp
[Previous turn undone.]

>take backpack
Taken.

Current Load: 0%    Max Load: 0%            Energy: 98%    Health: 100%

* * *

>wear backpack
(first taking the backpack)
You put on the backpack.

Current Load: 0%    Max Load: 100%            Energy: 98%    Health: 100%

>wear backpack
Current Load: 0%    Max Load: 100%            Energy: 97%    Health: 100%

>wear backpack
Current Load: 0%    Max Load: 100%            Energy: 96%    Health: 100%

>i
You are carrying:
  a backpack (being worn and open but empty)

Current Load: 0%    Max Load: 100%            Energy: 95%    Health: 100%

>close backpack
You close the backpack.

Current Load: 0%    Max Load: 100%            Energy: 94%    Health: 100%

* * *

>open chest
You open 'Basecamp Chest', revealing an orange, a cliff bar, beef jerky, chicken jerky, a water bottle, an ice axe, crampons, a rope, a first aid kit, a tent and a chemical warming pack.

Current Load: 0%    Max Load: 100%            Energy: 99%    Health: 100%

>x chest
The chest is empty.

* * *

>open chest
You open 'Basecamp Chest', revealing an orange, a cliff bar, beef jerky, chicken jerky, a water bottle, an ice axe, crampons, a rope, a first aid kit, a tent and a chemical warming pack.

Current Load: 0%    Max Load: 100%            Energy: 99%    Health: 100%

>x cliff
The cliff bar can replenish 15% of your energy but requires 6% of your load.

Current Load: 0%    Max Load: 100%            Energy: 98%    Health: 100%

>x beef
Beef jerky can replenish 25% of your energy but requires 10% of your load.

Current Load: 0%    Max Load: 100%            Energy: 97%    Health: 100%

>take bef
You can't see any such thing.

>take beef
Taken.

Current Load: 10%    Max Load: 100%            Energy: 96%    Health: 100%

>take chicken
Taken.

Current Load: 20%    Max Load: 100%            Energy: 95%    Health: 100%

>take tent
Taken.

Current Load: 40%    Max Load: 100%            Energy: 94%    Health: 100%

>take water
Taken.

Current Load: 55%    Max Load: 100%            Energy: 93%    Health: 100%

>take axe
Taken.

Current Load: 70%    Max Load: 100%            Energy: 92%    Health: 100%

>i
You are carrying:
  an ice axe
  a water bottle
  a tent
  chicken jerky
  beef jerky

Current Load: 70%    Max Load: 100%            Energy: 91%    Health: 100%

>take crampons
Taken.

Current Load: 85%    Max Load: 100%            Energy: 90%    Health: 100%

>go n
Are you sure you want to go to Camp1? This hike will require 20 energy.

>y
You make the trek to Camp1 and arrive late in the evening.

Camp1
Camp 1 (4900m)  At 16,076 feet above sea level, Camp 1 is higher than most people have every climbed. It is higher than any peak in North America. It is just 1000 feet lower than Everest Base Camp in Nepal. Camp 1 is located at the top of the trail on a plateau. Aconcagua is not visible from here, but its sister, Mt. Ameguino's snowy peak looms above you. The camp is located several hundred meters from the glacial stream. There is no outhouse (you must bury your waste, away from any area that could contaminate the stream). Carrying water from the stream to boil for hydration and cooking is required. You can only carry part of what you need to Camp 1 on your first trip, so you must plan carefully. Climbers stay one night in Camp 1, then return to Base Camp for more supplies. You have to bring the bare essentials - tent, sleeping bag, camp stove, food. You don't immediately need ice climbing equipment - mountaineering boots, crampons, ice ax, harness, helmet, rope. But you will eventually need to bring up to Camp 1, as it's needed at higher elevations.

--- Here, each action requires 2 energy points. And without energy, your health will decrease 12 points per action. ---

Current Load: 85%    Max Load: 100%            Energy: 68%    Health: 100%

>go n
It's dark out, and you need some sleep before making another trek.

Current Load: 85%    Max Load: 100%            Energy: 66%    Health: 100%

>sleep
Sleeping outdoors is a bad idea - it's freezing! You should find shelter but it's totally up to you. Are you sure you want to sleep here?

>n
Current Load: 85%    Max Load: 100%            Energy: 64%    Health: 100%

>drop tent
Dropped.

Current Load: 65%    Max Load: 100%            Energy: 62%    Health: 100%

>enter tent
You enter the tent. It's nice and cozy inside.

Current Load: 65%    Max Load: 100%            Energy: 82%    Health: 100%

>sleep
You close your eyes... and awake the next day at the crack of dawn.

You're rested and ready to continue. Your energy has increased by 20%.

Current Load: 65%    Max Load: 100%            Energy: 100%    Health: 100%

>exit tent
I only understood you as far as wanting to exit.

>go outside
There's no time for wandering around. We have a mountain to tackle - from South to North and then North to South.

Current Load: 65%    Max Load: 100%            Energy: 100%    Health: 100%

>leave tent
I only understood you as far as wanting to leave.

* * *

>open chest
You open 'Basecamp Chest', revealing an orange, a cliff bar, beef jerky, chicken jerky, a water bottle, an ice axe, crampons, a rope, a first aid kit, a tent and a chemical warming pack.

Current Load: 0%    Max Load: 100%            Energy: 99%    Health: 100%

>x self
As good-looking as ever.

Current Load: 0%    Max Load: 100%            Energy: 98%    Health: 100%

* * *

>open chest
You open 'Basecamp Chest', revealing an orange, a cliff bar, beef jerky, chicken jerky, a water bottle, an ice axe, crampons, a rope, a first aid kit, a tent and a chemical warming pack.

Current Load: 0%    Max Load: 100%            Energy: 99%    Health: 100%

>x water bottle
Each sip replenishes 10% of your energy and there are 7 sips remaining. Carrying this insulated bottle requires 15% of your load capacity.

Current Load: 0%    Max Load: 0%            Energy: 98%    Health: 100%

>wear backpack
(first taking the backpack)
You put on the backpack.

Current Load: 0%    Max Load: 100%            Energy: 97%    Health: 100%

>take all
orange: Taken.
cliff bar: (putting the orange into the backpack to make room)
Taken.
water bottle: (putting the cliff bar into the backpack to make room)
Taken.
ice axe: (putting the water bottle into the backpack to make room)
Taken.
crampons: (putting the ice axe into the backpack to make room)
Taken.
rope: (putting crampons into the backpack to make room)
Taken.
tent: (putting the rope into the backpack to make room)
Taken.
chemical warming pack: (putting the tent into the backpack to make room)
Taken.
small pack of jerkey: (putting the chemical warming pack into the backpack to make room)
Taken.

Current Load: 92%    Max Load: 100%            Energy: 96%    Health: 100%

>go n
Are you sure you want to go to Camp1? This hike will require 20 energy.

>i
Please answer yes or no.

>go n
Please answer yes or no.

>y
You make the trek to Camp1.

Camp1
Camp 1 (4900m)  At 16,076 feet above sea level, Camp 1 is higher than most people have every climbed. It is higher than any peak in North America. It is just 1000 feet lower than Everest Base Camp in Nepal. Camp 1 is located at the top of the trail on a plateau. Aconcagua is not visible from here, but its sister, Mt. Ameguino's snowy peak looms above you. The camp is located several hundred meters from the glacial stream. There is no outhouse (you must bury your waste, away from any area that could contaminate the stream). Carrying water from the stream to boil for hydration and cooking is required. You can only carry part of what you need to Camp 1 on your first trip, so you must plan carefully. Climbers stay one night in Camp 1, then return to Base Camp for more supplies. You have to bring the bare essentials - tent, sleeping bag, camp stove, food. You don't immediately need ice climbing equipment - mountaineering boots, crampons, ice ax, harness, helmet, rope. But you will eventually need to bring up to Camp 1, as it's needed at higher elevations.

--- Here, each action requires 2 energy points. And without energy, your health will decrease 12 points per action. ---

Current Load: 92%    Max Load: 100%            Energy: 74%    Health: 100%

>go n
You won't be able to carry all that up there because your max load at Camp2 is only 75%. You have to drop some items (though you can always come back for them).

Current Load: 92%    Max Load: 100%            Energy: 72%    Health: 100%

>y
That was a rhetorical question.

Current Load: 92%    Max Load: 100%            Energy: 70%    Health: 100%

>gon
That's not a verb I recognise.

>go n
You won't be able to carry all that up there because your max load at Camp2 is only 75%. You have to drop some items (though you can always come back for them).

Current Load: 92%    Max Load: 100%            Energy: 68%    Health: 100%

>y
That was a rhetorical question.

Current Load: 92%    Max Load: 100%            Energy: 66%    Health: 100%

>go n
You won't be able to carry all that up there because your max load at Camp2 is only 75%. You have to drop some items (though you can always come back for them).

Current Load: 92%    Max Load: 100%            Energy: 64%    Health: 100%

>y
That was a rhetorical question.

Current Load: 92%    Max Load: 100%            Energy: 62%    Health: 100%

>go n
You won't be able to carry all that up there because your max load at Camp2 is only 75%. You have to drop some items (though you can always come back for them).

Current Load: 92%    Max Load: 100%            Energy: 60%    Health: 100%

>x camp2
You can't see any such thing.

>map
That's not a verb I recognise.

>go n
You won't be able to carry all that up there because your max load at Camp2 is only 75%. You have to drop some items (though you can always come back for them).

Current Load: 92%    Max Load: 100%            Energy: 58%    Health: 100%

>i
You are carrying:
  a small pack of jerkey
  a backpack (being worn and open)
    a chemical warming pack
    a tent
    a rope
    crampons
    an ice axe
    a water bottle
    a cliff bar
    an orange

Current Load: 92%    Max Load: 100%            Energy: 56%    Health: 100%

>eat orange
Your energy has increased a bit.

Current Load: 92%    Max Load: 100%            Energy: 60%    Health: 100%

>i
You are carrying:
  a small pack of jerkey
  a backpack (being worn and open)
    a chemical warming pack
    a tent
    a rope
    crampons
    an ice axe
    a water bottle
    a cliff bar

Current Load: 92%    Max Load: 100%            Energy: 58%    Health: 100%

>eat jerkey
The small pack of jerkey might be edible, but you probably don't want test it out now.

Current Load: 92%    Max Load: 100%            Energy: 56%    Health: 100%

>eat the small pack of jerkey
The small pack of jerkey might be edible, but you probably don't want test it out now.

Current Load: 92%    Max Load: 100%            Energy: 54%    Health: 100%

>ACTIONS
Actions listing on.

>eat the small pack of jerkey
[eating the small pack of jerkey]
The small pack of jerkey might be edible, but you probably don't want test it out now.
[eating the small pack of jerkey - ended without result]

Current Load: 92%    Max Load: 100%            Energy: 52%    Health: 100%

>eat cliff bar
[eating the cliff bar]
Your energy has increased a bit.
[eating the cliff bar - failed]

Current Load: 92%    Max Load: 100%            Energy: 65%    Health: 100%

>i
[taking inventory]
You are carrying:
  a small pack of jerkey
  a backpack (being worn and open)
    a chemical warming pack
    a tent
    a rope
    crampons
    an ice axe
    a water bottle

[taking inventory - succeeded]

Current Load: 92%    Max Load: 100%            Energy: 63%    Health: 100%

* * *

>open chest1
You open Chest1, revealing an orange.

>eat chest1
Chest1 might be edible, but it's not what you'd consider really food.

>eat orange
(first taking the orange)
Your energy has increased from 80% to 100%.

>eat chest1
Chest1 might be edible, but it's not what you'd consider really food.

* * *

>open chest1
You open Chest1, revealing an orange.

>eat orange
(first taking the orange)
Your energy has increased from 80% to 100%.

>eat chest
You can't see any such thing.

>eat chest1
Chest1 might be edible, but it's not what you'd consider really food.

>eat chest1
Chest1 might be edible, but it's not what you'd consider really food.

* * *

>eat orange
(first taking the orange)
Your energy has increased from 80% to 100%.

>open chest1
That's already open.

>inspect chest1
That's not a verb I recognise.

>what's in chest1
That's not a verb I recognise.

>x chest1
Chest1 is empty.

* * *

>open chest1
You open Chest1, revealing an orange.

>inspect orange
That's not a verb I recognise.

>x orange
The orange can replenish 25% of your energy.

>eat orange
(first taking the orange)
too much
Your energy has increased from 100% to 125.

>i
You are carrying nothing.

>look around
You can't see any such thing.

>look
Basecamp
Plaza Argentina Base Camp (4200m). Plaza Argentina is a collection of ragtag temporary structures that form the Guardia's seasonal presence at the less popular Polish Route base camp. Brightly colored tents dot the plateau. The Polish Glacier looms in the distance, and a swift stream - the headwaters of the Vacas river flow from its base. There is an outhouse on the edge of camp. The weekly helicopter retrieval of the 50 gallon drum of waste is a highlight and one of the only things that marks civilized time.

You can see Chest1 (empty) here.

>x self
Health: 100%. Energy: 80.

>x self
Health: 100%. Energy: 80.

* * *

>open chest1
You open Chest1, revealing an orange.

>x chest1
Chest1 is empty.

* * *

>open matchbox
You open 'Matchbox', revealing a match.

>take match
Taken.

>burn match
This dangerous act would achieve little.

* * *

>open matchbox
You open 'Matchbox', revealing a match.

>x matchbox
The matchbox is empty.

>place matchbox on chest
That's not a verb I recognise.

>put matchbox on chest
You can't see any such thing.

* * *

>showme health count
There seems to be no such object anywhere in the model world.

* * *

>showme money
There seems to be no such object anywhere in the model world.

>showme health
There seems to be no such object anywhere in the model world.

* * *

>sip water
You can't see any such thing.

>open chest
You open 'Basecamp Chest', revealing an orange, a cliff bar, beef jerky, chicken jerky, a water bottle, an ice axe, crampons, a rope, a first aid kit, a tent and a chemical warming pack.

Current Load: 0%    Max Load: 100%            Energy: 99%    Health: 100%

>take water
Taken.

Current Load: 15%    Max Load: 100%            Energy: 98%    Health: 100%

>sip water
Aaaaahh! Very refreshing. Only 6 sips left.

Current Load: 15%    Max Load: 100%            Energy: 99%    Health: 100%

>l
Basecamp
Plaza Argentina Base Camp (4200m) for Mt. Aconcagua. The trail up to the summit begins here. It's a dangerous, but non-technical climb. There is a collection of ragtag temporary structures that form the Guardia's seasonal presence at the less popular Polish Route base camp. Brightly colored tents dot the plateau. The Polish Glacier looms in the distance, and a swift stream - the headwaters of the Vacas river flow from its base. There is an outhouse on the edge of camp. The weekly helicopter retrieval of the 50 gallon drum of waste is a highlight and one of the only things that marks civilized time.

--- Down here, each action requires 1 energy point. And without energy, your health will decrease 11 points per action. ---

You can see 'Basecamp Chest' (in which are an orange, a cliff bar, beef jerky, chicken jerky, an ice axe, crampons, a rope, a first aid kit, a tent (empty) and a chemical warming pack) here.

Current Load: 15%    Max Load: 100%            Energy: 98%    Health: 100%

>l
Basecamp
Plaza Argentina Base Camp (4200m) for Mt. Aconcagua. The trail up to the summit begins here. It's a dangerous, but non-technical climb. There is a collection of ragtag temporary structures that form the Guardia's seasonal presence at the less popular Polish Route base camp. Brightly colored tents dot the plateau. The Polish Glacier looms in the distance, and a swift stream - the headwaters of the Vacas river flow from its base. There is an outhouse on the edge of camp. The weekly helicopter retrieval of the 50 gallon drum of waste is a highlight and one of the only things that marks civilized time.

--- Down here, each action requires 1 energy point. And without energy, your health will decrease 11 points per action. ---

You can see 'Basecamp Chest' (in which are an orange, a cliff bar, beef jerky, chicken jerky, an ice axe, crampons, a rope, a first aid kit, a tent (empty) and a chemical warming pack) here.

Current Load: 15%    Max Load: 100%            Energy: 97%    Health: 100%

>l
Basecamp
Plaza Argentina Base Camp (4200m) for Mt. Aconcagua. The trail up to the summit begins here. It's a dangerous, but non-technical climb. There is a collection of ragtag temporary structures that form the Guardia's seasonal presence at the less popular Polish Route base camp. Brightly colored tents dot the plateau. The Polish Glacier looms in the distance, and a swift stream - the headwaters of the Vacas river flow from its base. There is an outhouse on the edge of camp. The weekly helicopter retrieval of the 50 gallon drum of waste is a highlight and one of the only things that marks civilized time.

--- Down here, each action requires 1 energy point. And without energy, your health will decrease 11 points per action. ---

You can see 'Basecamp Chest' (in which are an orange, a cliff bar, beef jerky, chicken jerky, an ice axe, crampons, a rope, a first aid kit, a tent (empty) and a chemical warming pack) here.

Current Load: 15%    Max Load: 100%            Energy: 96%    Health: 100%

>l
Basecamp
Plaza Argentina Base Camp (4200m) for Mt. Aconcagua. The trail up to the summit begins here. It's a dangerous, but non-technical climb. There is a collection of ragtag temporary structures that form the Guardia's seasonal presence at the less popular Polish Route base camp. Brightly colored tents dot the plateau. The Polish Glacier looms in the distance, and a swift stream - the headwaters of the Vacas river flow from its base. There is an outhouse on the edge of camp. The weekly helicopter retrieval of the 50 gallon drum of waste is a highlight and one of the only things that marks civilized time.

--- Down here, each action requires 1 energy point. And without energy, your health will decrease 11 points per action. ---

You can see 'Basecamp Chest' (in which are an orange, a cliff bar, beef jerky, chicken jerky, an ice axe, crampons, a rope, a first aid kit, a tent (empty) and a chemical warming pack) here.

Current Load: 15%    Max Load: 100%            Energy: 95%    Health: 100%

>ll
That's not a verb I recognise.

>ll
That's not a verb I recognise.

>l
Basecamp
Plaza Argentina Base Camp (4200m) for Mt. Aconcagua. The trail up to the summit begins here. It's a dangerous, but non-technical climb. There is a collection of ragtag temporary structures that form the Guardia's seasonal presence at the less popular Polish Route base camp. Brightly colored tents dot the plateau. The Polish Glacier looms in the distance, and a swift stream - the headwaters of the Vacas river flow from its base. There is an outhouse on the edge of camp. The weekly helicopter retrieval of the 50 gallon drum of waste is a highlight and one of the only things that marks civilized time.

--- Down here, each action requires 1 energy point. And without energy, your health will decrease 11 points per action. ---

You can see 'Basecamp Chest' (in which are an orange, a cliff bar, beef jerky, chicken jerky, an ice axe, crampons, a rope, a first aid kit, a tent (empty) and a chemical warming pack) here.

Current Load: 15%    Max Load: 100%            Energy: 94%    Health: 100%

>l
Basecamp
Plaza Argentina Base Camp (4200m) for Mt. Aconcagua. The trail up to the summit begins here. It's a dangerous, but non-technical climb. There is a collection of ragtag temporary structures that form the Guardia's seasonal presence at the less popular Polish Route base camp. Brightly colored tents dot the plateau. The Polish Glacier looms in the distance, and a swift stream - the headwaters of the Vacas river flow from its base. There is an outhouse on the edge of camp. The weekly helicopter retrieval of the 50 gallon drum of waste is a highlight and one of the only things that marks civilized time.

--- Down here, each action requires 1 energy point. And without energy, your health will decrease 11 points per action. ---

You can see 'Basecamp Chest' (in which are an orange, a cliff bar, beef jerky, chicken jerky, an ice axe, crampons, a rope, a first aid kit, a tent (empty) and a chemical warming pack) here.

Current Load: 15%    Max Load: 100%            Energy: 93%    Health: 100%

>l
Basecamp
Plaza Argentina Base Camp (4200m) for Mt. Aconcagua. The trail up to the summit begins here. It's a dangerous, but non-technical climb. There is a collection of ragtag temporary structures that form the Guardia's seasonal presence at the less popular Polish Route base camp. Brightly colored tents dot the plateau. The Polish Glacier looms in the distance, and a swift stream - the headwaters of the Vacas river flow from its base. There is an outhouse on the edge of camp. The weekly helicopter retrieval of the 50 gallon drum of waste is a highlight and one of the only things that marks civilized time.

--- Down here, each action requires 1 energy point. And without energy, your health will decrease 11 points per action. ---

You can see 'Basecamp Chest' (in which are an orange, a cliff bar, beef jerky, chicken jerky, an ice axe, crampons, a rope, a first aid kit, a tent (empty) and a chemical warming pack) here.

Current Load: 15%    Max Load: 100%            Energy: 92%    Health: 100%

>l
Basecamp
Plaza Argentina Base Camp (4200m) for Mt. Aconcagua. The trail up to the summit begins here. It's a dangerous, but non-technical climb. There is a collection of ragtag temporary structures that form the Guardia's seasonal presence at the less popular Polish Route base camp. Brightly colored tents dot the plateau. The Polish Glacier looms in the distance, and a swift stream - the headwaters of the Vacas river flow from its base. There is an outhouse on the edge of camp. The weekly helicopter retrieval of the 50 gallon drum of waste is a highlight and one of the only things that marks civilized time.

--- Down here, each action requires 1 energy point. And without energy, your health will decrease 11 points per action. ---

You can see 'Basecamp Chest' (in which are an orange, a cliff bar, beef jerky, chicken jerky, an ice axe, crampons, a rope, a first aid kit, a tent (empty) and a chemical warming pack) here.

Current Load: 15%    Max Load: 100%            Energy: 91%    Health: 100%

>l
Basecamp
Plaza Argentina Base Camp (4200m) for Mt. Aconcagua. The trail up to the summit begins here. It's a dangerous, but non-technical climb. There is a collection of ragtag temporary structures that form the Guardia's seasonal presence at the less popular Polish Route base camp. Brightly colored tents dot the plateau. The Polish Glacier looms in the distance, and a swift stream - the headwaters of the Vacas river flow from its base. There is an outhouse on the edge of camp. The weekly helicopter retrieval of the 50 gallon drum of waste is a highlight and one of the only things that marks civilized time.

--- Down here, each action requires 1 energy point. And without energy, your health will decrease 11 points per action. ---

You can see 'Basecamp Chest' (in which are an orange, a cliff bar, beef jerky, chicken jerky, an ice axe, crampons, a rope, a first aid kit, a tent (empty) and a chemical warming pack) here.

Current Load: 15%    Max Load: 100%            Energy: 90%    Health: 100%

I beg your pardon?

>l
Basecamp
Plaza Argentina Base Camp (4200m) for Mt. Aconcagua. The trail up to the summit begins here. It's a dangerous, but non-technical climb. There is a collection of ragtag temporary structures that form the Guardia's seasonal presence at the less popular Polish Route base camp. Brightly colored tents dot the plateau. The Polish Glacier looms in the distance, and a swift stream - the headwaters of the Vacas river flow from its base. There is an outhouse on the edge of camp. The weekly helicopter retrieval of the 50 gallon drum of waste is a highlight and one of the only things that marks civilized time.

--- Down here, each action requires 1 energy point. And without energy, your health will decrease 11 points per action. ---

You can see 'Basecamp Chest' (in which are an orange, a cliff bar, beef jerky, chicken jerky, an ice axe, crampons, a rope, a first aid kit, a tent (empty) and a chemical warming pack) here.

Current Load: 15%    Max Load: 100%            Energy: 89%    Health: 100%

>l
Basecamp
Plaza Argentina Base Camp (4200m) for Mt. Aconcagua. The trail up to the summit begins here. It's a dangerous, but non-technical climb. There is a collection of ragtag temporary structures that form the Guardia's seasonal presence at the less popular Polish Route base camp. Brightly colored tents dot the plateau. The Polish Glacier looms in the distance, and a swift stream - the headwaters of the Vacas river flow from its base. There is an outhouse on the edge of camp. The weekly helicopter retrieval of the 50 gallon drum of waste is a highlight and one of the only things that marks civilized time.

--- Down here, each action requires 1 energy point. And without energy, your health will decrease 11 points per action. ---

You can see 'Basecamp Chest' (in which are an orange, a cliff bar, beef jerky, chicken jerky, an ice axe, crampons, a rope, a first aid kit, a tent (empty) and a chemical warming pack) here.

Current Load: 15%    Max Load: 100%            Energy: 88%    Health: 100%

>l
Basecamp
Plaza Argentina Base Camp (4200m) for Mt. Aconcagua. The trail up to the summit begins here. It's a dangerous, but non-technical climb. There is a collection of ragtag temporary structures that form the Guardia's seasonal presence at the less popular Polish Route base camp. Brightly colored tents dot the plateau. The Polish Glacier looms in the distance, and a swift stream - the headwaters of the Vacas river flow from its base. There is an outhouse on the edge of camp. The weekly helicopter retrieval of the 50 gallon drum of waste is a highlight and one of the only things that marks civilized time.

--- Down here, each action requires 1 energy point. And without energy, your health will decrease 11 points per action. ---

You can see 'Basecamp Chest' (in which are an orange, a cliff bar, beef jerky, chicken jerky, an ice axe, crampons, a rope, a first aid kit, a tent (empty) and a chemical warming pack) here.

Current Load: 15%    Max Load: 100%            Energy: 87%    Health: 100%

>l
Basecamp
Plaza Argentina Base Camp (4200m) for Mt. Aconcagua. The trail up to the summit begins here. It's a dangerous, but non-technical climb. There is a collection of ragtag temporary structures that form the Guardia's seasonal presence at the less popular Polish Route base camp. Brightly colored tents dot the plateau. The Polish Glacier looms in the distance, and a swift stream - the headwaters of the Vacas river flow from its base. There is an outhouse on the edge of camp. The weekly helicopter retrieval of the 50 gallon drum of waste is a highlight and one of the only things that marks civilized time.

--- Down here, each action requires 1 energy point. And without energy, your health will decrease 11 points per action. ---

You can see 'Basecamp Chest' (in which are an orange, a cliff bar, beef jerky, chicken jerky, an ice axe, crampons, a rope, a first aid kit, a tent (empty) and a chemical warming pack) here.

Current Load: 15%    Max Load: 100%            Energy: 86%    Health: 100%

>l
Basecamp
Plaza Argentina Base Camp (4200m) for Mt. Aconcagua. The trail up to the summit begins here. It's a dangerous, but non-technical climb. There is a collection of ragtag temporary structures that form the Guardia's seasonal presence at the less popular Polish Route base camp. Brightly colored tents dot the plateau. The Polish Glacier looms in the distance, and a swift stream - the headwaters of the Vacas river flow from its base. There is an outhouse on the edge of camp. The weekly helicopter retrieval of the 50 gallon drum of waste is a highlight and one of the only things that marks civilized time.

--- Down here, each action requires 1 energy point. And without energy, your health will decrease 11 points per action. ---

You can see 'Basecamp Chest' (in which are an orange, a cliff bar, beef jerky, chicken jerky, an ice axe, crampons, a rope, a first aid kit, a tent (empty) and a chemical warming pack) here.

Current Load: 15%    Max Load: 100%            Energy: 85%    Health: 100%

>l
Basecamp
Plaza Argentina Base Camp (4200m) for Mt. Aconcagua. The trail up to the summit begins here. It's a dangerous, but non-technical climb. There is a collection of ragtag temporary structures that form the Guardia's seasonal presence at the less popular Polish Route base camp. Brightly colored tents dot the plateau. The Polish Glacier looms in the distance, and a swift stream - the headwaters of the Vacas river flow from its base. There is an outhouse on the edge of camp. The weekly helicopter retrieval of the 50 gallon drum of waste is a highlight and one of the only things that marks civilized time.

--- Down here, each action requires 1 energy point. And without energy, your health will decrease 11 points per action. ---

You can see 'Basecamp Chest' (in which are an orange, a cliff bar, beef jerky, chicken jerky, an ice axe, crampons, a rope, a first aid kit, a tent (empty) and a chemical warming pack) here.

Current Load: 15%    Max Load: 100%            Energy: 84%    Health: 100%

>l
Basecamp
Plaza Argentina Base Camp (4200m) for Mt. Aconcagua. The trail up to the summit begins here. It's a dangerous, but non-technical climb. There is a collection of ragtag temporary structures that form the Guardia's seasonal presence at the less popular Polish Route base camp. Brightly colored tents dot the plateau. The Polish Glacier looms in the distance, and a swift stream - the headwaters of the Vacas river flow from its base. There is an outhouse on the edge of camp. The weekly helicopter retrieval of the 50 gallon drum of waste is a highlight and one of the only things that marks civilized time.

--- Down here, each action requires 1 energy point. And without energy, your health will decrease 11 points per action. ---

You can see 'Basecamp Chest' (in which are an orange, a cliff bar, beef jerky, chicken jerky, an ice axe, crampons, a rope, a first aid kit, a tent (empty) and a chemical warming pack) here.

Current Load: 15%    Max Load: 100%            Energy: 83%    Health: 100%

>l
Basecamp
Plaza Argentina Base Camp (4200m) for Mt. Aconcagua. The trail up to the summit begins here. It's a dangerous, but non-technical climb. There is a collection of ragtag temporary structures that form the Guardia's seasonal presence at the less popular Polish Route base camp. Brightly colored tents dot the plateau. The Polish Glacier looms in the distance, and a swift stream - the headwaters of the Vacas river flow from its base. There is an outhouse on the edge of camp. The weekly helicopter retrieval of the 50 gallon drum of waste is a highlight and one of the only things that marks civilized time.

--- Down here, each action requires 1 energy point. And without energy, your health will decrease 11 points per action. ---

You can see 'Basecamp Chest' (in which are an orange, a cliff bar, beef jerky, chicken jerky, an ice axe, crampons, a rope, a first aid kit, a tent (empty) and a chemical warming pack) here.

Current Load: 15%    Max Load: 100%            Energy: 82%    Health: 100%

>l
Basecamp
Plaza Argentina Base Camp (4200m) for Mt. Aconcagua. The trail up to the summit begins here. It's a dangerous, but non-technical climb. There is a collection of ragtag temporary structures that form the Guardia's seasonal presence at the less popular Polish Route base camp. Brightly colored tents dot the plateau. The Polish Glacier looms in the distance, and a swift stream - the headwaters of the Vacas river flow from its base. There is an outhouse on the edge of camp. The weekly helicopter retrieval of the 50 gallon drum of waste is a highlight and one of the only things that marks civilized time.

--- Down here, each action requires 1 energy point. And without energy, your health will decrease 11 points per action. ---

You can see 'Basecamp Chest' (in which are an orange, a cliff bar, beef jerky, chicken jerky, an ice axe, crampons, a rope, a first aid kit, a tent (empty) and a chemical warming pack) here.

Current Load: 15%    Max Load: 100%            Energy: 81%    Health: 100%

>l
Basecamp
Plaza Argentina Base Camp (4200m) for Mt. Aconcagua. The trail up to the summit begins here. It's a dangerous, but non-technical climb. There is a collection of ragtag temporary structures that form the Guardia's seasonal presence at the less popular Polish Route base camp. Brightly colored tents dot the plateau. The Polish Glacier looms in the distance, and a swift stream - the headwaters of the Vacas river flow from its base. There is an outhouse on the edge of camp. The weekly helicopter retrieval of the 50 gallon drum of waste is a highlight and one of the only things that marks civilized time.

--- Down here, each action requires 1 energy point. And without energy, your health will decrease 11 points per action. ---

You can see 'Basecamp Chest' (in which are an orange, a cliff bar, beef jerky, chicken jerky, an ice axe, crampons, a rope, a first aid kit, a tent (empty) and a chemical warming pack) here.

Current Load: 15%    Max Load: 100%            Energy: 80%    Health: 100%

>l
Basecamp
Plaza Argentina Base Camp (4200m) for Mt. Aconcagua. The trail up to the summit begins here. It's a dangerous, but non-technical climb. There is a collection of ragtag temporary structures that form the Guardia's seasonal presence at the less popular Polish Route base camp. Brightly colored tents dot the plateau. The Polish Glacier looms in the distance, and a swift stream - the headwaters of the Vacas river flow from its base. There is an outhouse on the edge of camp. The weekly helicopter retrieval of the 50 gallon drum of waste is a highlight and one of the only things that marks civilized time.

--- Down here, each action requires 1 energy point. And without energy, your health will decrease 11 points per action. ---

You can see 'Basecamp Chest' (in which are an orange, a cliff bar, beef jerky, chicken jerky, an ice axe, crampons, a rope, a first aid kit, a tent (empty) and a chemical warming pack) here.

Current Load: 15%    Max Load: 100%            Energy: 79%    Health: 100%

>l
Basecamp
Plaza Argentina Base Camp (4200m) for Mt. Aconcagua. The trail up to the summit begins here. It's a dangerous, but non-technical climb. There is a collection of ragtag temporary structures that form the Guardia's seasonal presence at the less popular Polish Route base camp. Brightly colored tents dot the plateau. The Polish Glacier looms in the distance, and a swift stream - the headwaters of the Vacas river flow from its base. There is an outhouse on the edge of camp. The weekly helicopter retrieval of the 50 gallon drum of waste is a highlight and one of the only things that marks civilized time.

--- Down here, each action requires 1 energy point. And without energy, your health will decrease 11 points per action. ---

You can see 'Basecamp Chest' (in which are an orange, a cliff bar, beef jerky, chicken jerky, an ice axe, crampons, a rope, a first aid kit, a tent (empty) and a chemical warming pack) here.

Current Load: 15%    Max Load: 100%            Energy: 78%    Health: 100%

I beg your pardon?

>l
Basecamp
Plaza Argentina Base Camp (4200m) for Mt. Aconcagua. The trail up to the summit begins here. It's a dangerous, but non-technical climb. There is a collection of ragtag temporary structures that form the Guardia's seasonal presence at the less popular Polish Route base camp. Brightly colored tents dot the plateau. The Polish Glacier looms in the distance, and a swift stream - the headwaters of the Vacas river flow from its base. There is an outhouse on the edge of camp. The weekly helicopter retrieval of the 50 gallon drum of waste is a highlight and one of the only things that marks civilized time.

--- Down here, each action requires 1 energy point. And without energy, your health will decrease 11 points per action. ---

You can see 'Basecamp Chest' (in which are an orange, a cliff bar, beef jerky, chicken jerky, an ice axe, crampons, a rope, a first aid kit, a tent (empty) and a chemical warming pack) here.

Current Load: 15%    Max Load: 100%            Energy: 77%    Health: 100%

>l
Basecamp
Plaza Argentina Base Camp (4200m) for Mt. Aconcagua. The trail up to the summit begins here. It's a dangerous, but non-technical climb. There is a collection of ragtag temporary structures that form the Guardia's seasonal presence at the less popular Polish Route base camp. Brightly colored tents dot the plateau. The Polish Glacier looms in the distance, and a swift stream - the headwaters of the Vacas river flow from its base. There is an outhouse on the edge of camp. The weekly helicopter retrieval of the 50 gallon drum of waste is a highlight and one of the only things that marks civilized time.

--- Down here, each action requires 1 energy point. And without energy, your health will decrease 11 points per action. ---

You can see 'Basecamp Chest' (in which are an orange, a cliff bar, beef jerky, chicken jerky, an ice axe, crampons, a rope, a first aid kit, a tent (empty) and a chemical warming pack) here.

Current Load: 15%    Max Load: 100%            Energy: 76%    Health: 100%

>l
Basecamp
Plaza Argentina Base Camp (4200m) for Mt. Aconcagua. The trail up to the summit begins here. It's a dangerous, but non-technical climb. There is a collection of ragtag temporary structures that form the Guardia's seasonal presence at the less popular Polish Route base camp. Brightly colored tents dot the plateau. The Polish Glacier looms in the distance, and a swift stream - the headwaters of the Vacas river flow from its base. There is an outhouse on the edge of camp. The weekly helicopter retrieval of the 50 gallon drum of waste is a highlight and one of the only things that marks civilized time.

--- Down here, each action requires 1 energy point. And without energy, your health will decrease 11 points per action. ---

You can see 'Basecamp Chest' (in which are an orange, a cliff bar, beef jerky, chicken jerky, an ice axe, crampons, a rope, a first aid kit, a tent (empty) and a chemical warming pack) here.

Current Load: 15%    Max Load: 100%            Energy: 75%    Health: 100%

I beg your pardon?

>l
Basecamp
Plaza Argentina Base Camp (4200m) for Mt. Aconcagua. The trail up to the summit begins here. It's a dangerous, but non-technical climb. There is a collection of ragtag temporary structures that form the Guardia's seasonal presence at the less popular Polish Route base camp. Brightly colored tents dot the plateau. The Polish Glacier looms in the distance, and a swift stream - the headwaters of the Vacas river flow from its base. There is an outhouse on the edge of camp. The weekly helicopter retrieval of the 50 gallon drum of waste is a highlight and one of the only things that marks civilized time.

--- Down here, each action requires 1 energy point. And without energy, your health will decrease 11 points per action. ---

You can see 'Basecamp Chest' (in which are an orange, a cliff bar, beef jerky, chicken jerky, an ice axe, crampons, a rope, a first aid kit, a tent (empty) and a chemical warming pack) here.

Current Load: 15%    Max Load: 100%            Energy: 74%    Health: 100%

>l
Basecamp
Plaza Argentina Base Camp (4200m) for Mt. Aconcagua. The trail up to the summit begins here. It's a dangerous, but non-technical climb. There is a collection of ragtag temporary structures that form the Guardia's seasonal presence at the less popular Polish Route base camp. Brightly colored tents dot the plateau. The Polish Glacier looms in the distance, and a swift stream - the headwaters of the Vacas river flow from its base. There is an outhouse on the edge of camp. The weekly helicopter retrieval of the 50 gallon drum of waste is a highlight and one of the only things that marks civilized time.

--- Down here, each action requires 1 energy point. And without energy, your health will decrease 11 points per action. ---

You can see 'Basecamp Chest' (in which are an orange, a cliff bar, beef jerky, chicken jerky, an ice axe, crampons, a rope, a first aid kit, a tent (empty) and a chemical warming pack) here.

Current Load: 15%    Max Load: 100%            Energy: 73%    Health: 100%

>l
Basecamp
Plaza Argentina Base Camp (4200m) for Mt. Aconcagua. The trail up to the summit begins here. It's a dangerous, but non-technical climb. There is a collection of ragtag temporary structures that form the Guardia's seasonal presence at the less popular Polish Route base camp. Brightly colored tents dot the plateau. The Polish Glacier looms in the distance, and a swift stream - the headwaters of the Vacas river flow from its base. There is an outhouse on the edge of camp. The weekly helicopter retrieval of the 50 gallon drum of waste is a highlight and one of the only things that marks civilized time.

--- Down here, each action requires 1 energy point. And without energy, your health will decrease 11 points per action. ---

You can see 'Basecamp Chest' (in which are an orange, a cliff bar, beef jerky, chicken jerky, an ice axe, crampons, a rope, a first aid kit, a tent (empty) and a chemical warming pack) here.

Current Load: 15%    Max Load: 100%            Energy: 72%    Health: 100%

>l
Basecamp
Plaza Argentina Base Camp (4200m) for Mt. Aconcagua. The trail up to the summit begins here. It's a dangerous, but non-technical climb. There is a collection of ragtag temporary structures that form the Guardia's seasonal presence at the less popular Polish Route base camp. Brightly colored tents dot the plateau. The Polish Glacier looms in the distance, and a swift stream - the headwaters of the Vacas river flow from its base. There is an outhouse on the edge of camp. The weekly helicopter retrieval of the 50 gallon drum of waste is a highlight and one of the only things that marks civilized time.

--- Down here, each action requires 1 energy point. And without energy, your health will decrease 11 points per action. ---

You can see 'Basecamp Chest' (in which are an orange, a cliff bar, beef jerky, chicken jerky, an ice axe, crampons, a rope, a first aid kit, a tent (empty) and a chemical warming pack) here.

Current Load: 15%    Max Load: 100%            Energy: 71%    Health: 100%

>l
Basecamp
Plaza Argentina Base Camp (4200m) for Mt. Aconcagua. The trail up to the summit begins here. It's a dangerous, but non-technical climb. There is a collection of ragtag temporary structures that form the Guardia's seasonal presence at the less popular Polish Route base camp. Brightly colored tents dot the plateau. The Polish Glacier looms in the distance, and a swift stream - the headwaters of the Vacas river flow from its base. There is an outhouse on the edge of camp. The weekly helicopter retrieval of the 50 gallon drum of waste is a highlight and one of the only things that marks civilized time.

--- Down here, each action requires 1 energy point. And without energy, your health will decrease 11 points per action. ---

You can see 'Basecamp Chest' (in which are an orange, a cliff bar, beef jerky, chicken jerky, an ice axe, crampons, a rope, a first aid kit, a tent (empty) and a chemical warming pack) here.

Current Load: 15%    Max Load: 100%            Energy: 70%    Health: 100%

>l
Basecamp
Plaza Argentina Base Camp (4200m) for Mt. Aconcagua. The trail up to the summit begins here. It's a dangerous, but non-technical climb. There is a collection of ragtag temporary structures that form the Guardia's seasonal presence at the less popular Polish Route base camp. Brightly colored tents dot the plateau. The Polish Glacier looms in the distance, and a swift stream - the headwaters of the Vacas river flow from its base. There is an outhouse on the edge of camp. The weekly helicopter retrieval of the 50 gallon drum of waste is a highlight and one of the only things that marks civilized time.

--- Down here, each action requires 1 energy point. And without energy, your health will decrease 11 points per action. ---

You can see 'Basecamp Chest' (in which are an orange, a cliff bar, beef jerky, chicken jerky, an ice axe, crampons, a rope, a first aid kit, a tent (empty) and a chemical warming pack) here.

Current Load: 15%    Max Load: 100%            Energy: 69%    Health: 100%

>l
Basecamp
Plaza Argentina Base Camp (4200m) for Mt. Aconcagua. The trail up to the summit begins here. It's a dangerous, but non-technical climb. There is a collection of ragtag temporary structures that form the Guardia's seasonal presence at the less popular Polish Route base camp. Brightly colored tents dot the plateau. The Polish Glacier looms in the distance, and a swift stream - the headwaters of the Vacas river flow from its base. There is an outhouse on the edge of camp. The weekly helicopter retrieval of the 50 gallon drum of waste is a highlight and one of the only things that marks civilized time.

--- Down here, each action requires 1 energy point. And without energy, your health will decrease 11 points per action. ---

You can see 'Basecamp Chest' (in which are an orange, a cliff bar, beef jerky, chicken jerky, an ice axe, crampons, a rope, a first aid kit, a tent (empty) and a chemical warming pack) here.

Current Load: 15%    Max Load: 100%            Energy: 68%    Health: 100%

>l
Basecamp
Plaza Argentina Base Camp (4200m) for Mt. Aconcagua. The trail up to the summit begins here. It's a dangerous, but non-technical climb. There is a collection of ragtag temporary structures that form the Guardia's seasonal presence at the less popular Polish Route base camp. Brightly colored tents dot the plateau. The Polish Glacier looms in the distance, and a swift stream - the headwaters of the Vacas river flow from its base. There is an outhouse on the edge of camp. The weekly helicopter retrieval of the 50 gallon drum of waste is a highlight and one of the only things that marks civilized time.

--- Down here, each action requires 1 energy point. And without energy, your health will decrease 11 points per action. ---

You can see 'Basecamp Chest' (in which are an orange, a cliff bar, beef jerky, chicken jerky, an ice axe, crampons, a rope, a first aid kit, a tent (empty) and a chemical warming pack) here.

Current Load: 15%    Max Load: 100%            Energy: 67%    Health: 100%

I beg your pardon?

>l
Basecamp
Plaza Argentina Base Camp (4200m) for Mt. Aconcagua. The trail up to the summit begins here. It's a dangerous, but non-technical climb. There is a collection of ragtag temporary structures that form the Guardia's seasonal presence at the less popular Polish Route base camp. Brightly colored tents dot the plateau. The Polish Glacier looms in the distance, and a swift stream - the headwaters of the Vacas river flow from its base. There is an outhouse on the edge of camp. The weekly helicopter retrieval of the 50 gallon drum of waste is a highlight and one of the only things that marks civilized time.

--- Down here, each action requires 1 energy point. And without energy, your health will decrease 11 points per action. ---

You can see 'Basecamp Chest' (in which are an orange, a cliff bar, beef jerky, chicken jerky, an ice axe, crampons, a rope, a first aid kit, a tent (empty) and a chemical warming pack) here.

Current Load: 15%    Max Load: 100%            Energy: 66%    Health: 100%

>l
Basecamp
Plaza Argentina Base Camp (4200m) for Mt. Aconcagua. The trail up to the summit begins here. It's a dangerous, but non-technical climb. There is a collection of ragtag temporary structures that form the Guardia's seasonal presence at the less popular Polish Route base camp. Brightly colored tents dot the plateau. The Polish Glacier looms in the distance, and a swift stream - the headwaters of the Vacas river flow from its base. There is an outhouse on the edge of camp. The weekly helicopter retrieval of the 50 gallon drum of waste is a highlight and one of the only things that marks civilized time.

--- Down here, each action requires 1 energy point. And without energy, your health will decrease 11 points per action. ---

You can see 'Basecamp Chest' (in which are an orange, a cliff bar, beef jerky, chicken jerky, an ice axe, crampons, a rope, a first aid kit, a tent (empty) and a chemical warming pack) here.

Current Load: 15%    Max Load: 100%            Energy: 65%    Health: 100%

>l
Basecamp
Plaza Argentina Base Camp (4200m) for Mt. Aconcagua. The trail up to the summit begins here. It's a dangerous, but non-technical climb. There is a collection of ragtag temporary structures that form the Guardia's seasonal presence at the less popular Polish Route base camp. Brightly colored tents dot the plateau. The Polish Glacier looms in the distance, and a swift stream - the headwaters of the Vacas river flow from its base. There is an outhouse on the edge of camp. The weekly helicopter retrieval of the 50 gallon drum of waste is a highlight and one of the only things that marks civilized time.

--- Down here, each action requires 1 energy point. And without energy, your health will decrease 11 points per action. ---

You can see 'Basecamp Chest' (in which are an orange, a cliff bar, beef jerky, chicken jerky, an ice axe, crampons, a rope, a first aid kit, a tent (empty) and a chemical warming pack) here.

Current Load: 15%    Max Load: 100%            Energy: 64%    Health: 100%

>l
Basecamp
Plaza Argentina Base Camp (4200m) for Mt. Aconcagua. The trail up to the summit begins here. It's a dangerous, but non-technical climb. There is a collection of ragtag temporary structures that form the Guardia's seasonal presence at the less popular Polish Route base camp. Brightly colored tents dot the plateau. The Polish Glacier looms in the distance, and a swift stream - the headwaters of the Vacas river flow from its base. There is an outhouse on the edge of camp. The weekly helicopter retrieval of the 50 gallon drum of waste is a highlight and one of the only things that marks civilized time.

--- Down here, each action requires 1 energy point. And without energy, your health will decrease 11 points per action. ---

You can see 'Basecamp Chest' (in which are an orange, a cliff bar, beef jerky, chicken jerky, an ice axe, crampons, a rope, a first aid kit, a tent (empty) and a chemical warming pack) here.

Current Load: 15%    Max Load: 100%            Energy: 63%    Health: 100%

>l
Basecamp
Plaza Argentina Base Camp (4200m) for Mt. Aconcagua. The trail up to the summit begins here. It's a dangerous, but non-technical climb. There is a collection of ragtag temporary structures that form the Guardia's seasonal presence at the less popular Polish Route base camp. Brightly colored tents dot the plateau. The Polish Glacier looms in the distance, and a swift stream - the headwaters of the Vacas river flow from its base. There is an outhouse on the edge of camp. The weekly helicopter retrieval of the 50 gallon drum of waste is a highlight and one of the only things that marks civilized time.

--- Down here, each action requires 1 energy point. And without energy, your health will decrease 11 points per action. ---

You can see 'Basecamp Chest' (in which are an orange, a cliff bar, beef jerky, chicken jerky, an ice axe, crampons, a rope, a first aid kit, a tent (empty) and a chemical warming pack) here.

Current Load: 15%    Max Load: 100%            Energy: 62%    Health: 100%

I beg your pardon?

>l
Basecamp
Plaza Argentina Base Camp (4200m) for Mt. Aconcagua. The trail up to the summit begins here. It's a dangerous, but non-technical climb. There is a collection of ragtag temporary structures that form the Guardia's seasonal presence at the less popular Polish Route base camp. Brightly colored tents dot the plateau. The Polish Glacier looms in the distance, and a swift stream - the headwaters of the Vacas river flow from its base. There is an outhouse on the edge of camp. The weekly helicopter retrieval of the 50 gallon drum of waste is a highlight and one of the only things that marks civilized time.

--- Down here, each action requires 1 energy point. And without energy, your health will decrease 11 points per action. ---

You can see 'Basecamp Chest' (in which are an orange, a cliff bar, beef jerky, chicken jerky, an ice axe, crampons, a rope, a first aid kit, a tent (empty) and a chemical warming pack) here.

Current Load: 15%    Max Load: 100%            Energy: 61%    Health: 100%

>l
Basecamp
Plaza Argentina Base Camp (4200m) for Mt. Aconcagua. The trail up to the summit begins here. It's a dangerous, but non-technical climb. There is a collection of ragtag temporary structures that form the Guardia's seasonal presence at the less popular Polish Route base camp. Brightly colored tents dot the plateau. The Polish Glacier looms in the distance, and a swift stream - the headwaters of the Vacas river flow from its base. There is an outhouse on the edge of camp. The weekly helicopter retrieval of the 50 gallon drum of waste is a highlight and one of the only things that marks civilized time.

--- Down here, each action requires 1 energy point. And without energy, your health will decrease 11 points per action. ---

You can see 'Basecamp Chest' (in which are an orange, a cliff bar, beef jerky, chicken jerky, an ice axe, crampons, a rope, a first aid kit, a tent (empty) and a chemical warming pack) here.

Current Load: 15%    Max Load: 100%            Energy: 60%    Health: 100%

>ll
That's not a verb I recognise.

>l
Basecamp
Plaza Argentina Base Camp (4200m) for Mt. Aconcagua. The trail up to the summit begins here. It's a dangerous, but non-technical climb. There is a collection of ragtag temporary structures that form the Guardia's seasonal presence at the less popular Polish Route base camp. Brightly colored tents dot the plateau. The Polish Glacier looms in the distance, and a swift stream - the headwaters of the Vacas river flow from its base. There is an outhouse on the edge of camp. The weekly helicopter retrieval of the 50 gallon drum of waste is a highlight and one of the only things that marks civilized time.

--- Down here, each action requires 1 energy point. And without energy, your health will decrease 11 points per action. ---

You can see 'Basecamp Chest' (in which are an orange, a cliff bar, beef jerky, chicken jerky, an ice axe, crampons, a rope, a first aid kit, a tent (empty) and a chemical warming pack) here.

Current Load: 15%    Max Load: 100%            Energy: 59%    Health: 100%

>l
Basecamp
Plaza Argentina Base Camp (4200m) for Mt. Aconcagua. The trail up to the summit begins here. It's a dangerous, but non-technical climb. There is a collection of ragtag temporary structures that form the Guardia's seasonal presence at the less popular Polish Route base camp. Brightly colored tents dot the plateau. The Polish Glacier looms in the distance, and a swift stream - the headwaters of the Vacas river flow from its base. There is an outhouse on the edge of camp. The weekly helicopter retrieval of the 50 gallon drum of waste is a highlight and one of the only things that marks civilized time.

--- Down here, each action requires 1 energy point. And without energy, your health will decrease 11 points per action. ---

You can see 'Basecamp Chest' (in which are an orange, a cliff bar, beef jerky, chicken jerky, an ice axe, crampons, a rope, a first aid kit, a tent (empty) and a chemical warming pack) here.

Current Load: 15%    Max Load: 100%            Energy: 58%    Health: 100%

>l
Basecamp
Plaza Argentina Base Camp (4200m) for Mt. Aconcagua. The trail up to the summit begins here. It's a dangerous, but non-technical climb. There is a collection of ragtag temporary structures that form the Guardia's seasonal presence at the less popular Polish Route base camp. Brightly colored tents dot the plateau. The Polish Glacier looms in the distance, and a swift stream - the headwaters of the Vacas river flow from its base. There is an outhouse on the edge of camp. The weekly helicopter retrieval of the 50 gallon drum of waste is a highlight and one of the only things that marks civilized time.

--- Down here, each action requires 1 energy point. And without energy, your health will decrease 11 points per action. ---

You can see 'Basecamp Chest' (in which are an orange, a cliff bar, beef jerky, chicken jerky, an ice axe, crampons, a rope, a first aid kit, a tent (empty) and a chemical warming pack) here.

Current Load: 15%    Max Load: 100%            Energy: 57%    Health: 100%

>l
Basecamp
Plaza Argentina Base Camp (4200m) for Mt. Aconcagua. The trail up to the summit begins here. It's a dangerous, but non-technical climb. There is a collection of ragtag temporary structures that form the Guardia's seasonal presence at the less popular Polish Route base camp. Brightly colored tents dot the plateau. The Polish Glacier looms in the distance, and a swift stream - the headwaters of the Vacas river flow from its base. There is an outhouse on the edge of camp. The weekly helicopter retrieval of the 50 gallon drum of waste is a highlight and one of the only things that marks civilized time.

--- Down here, each action requires 1 energy point. And without energy, your health will decrease 11 points per action. ---

You can see 'Basecamp Chest' (in which are an orange, a cliff bar, beef jerky, chicken jerky, an ice axe, crampons, a rope, a first aid kit, a tent (empty) and a chemical warming pack) here.

Current Load: 15%    Max Load: 100%            Energy: 56%    Health: 100%

>l
Basecamp
Plaza Argentina Base Camp (4200m) for Mt. Aconcagua. The trail up to the summit begins here. It's a dangerous, but non-technical climb. There is a collection of ragtag temporary structures that form the Guardia's seasonal presence at the less popular Polish Route base camp. Brightly colored tents dot the plateau. The Polish Glacier looms in the distance, and a swift stream - the headwaters of the Vacas river flow from its base. There is an outhouse on the edge of camp. The weekly helicopter retrieval of the 50 gallon drum of waste is a highlight and one of the only things that marks civilized time.

--- Down here, each action requires 1 energy point. And without energy, your health will decrease 11 points per action. ---

You can see 'Basecamp Chest' (in which are an orange, a cliff bar, beef jerky, chicken jerky, an ice axe, crampons, a rope, a first aid kit, a tent (empty) and a chemical warming pack) here.

Current Load: 15%    Max Load: 100%            Energy: 55%    Health: 100%

>l
Basecamp
Plaza Argentina Base Camp (4200m) for Mt. Aconcagua. The trail up to the summit begins here. It's a dangerous, but non-technical climb. There is a collection of ragtag temporary structures that form the Guardia's seasonal presence at the less popular Polish Route base camp. Brightly colored tents dot the plateau. The Polish Glacier looms in the distance, and a swift stream - the headwaters of the Vacas river flow from its base. There is an outhouse on the edge of camp. The weekly helicopter retrieval of the 50 gallon drum of waste is a highlight and one of the only things that marks civilized time.

--- Down here, each action requires 1 energy point. And without energy, your health will decrease 11 points per action. ---

You can see 'Basecamp Chest' (in which are an orange, a cliff bar, beef jerky, chicken jerky, an ice axe, crampons, a rope, a first aid kit, a tent (empty) and a chemical warming pack) here.

Current Load: 15%    Max Load: 100%            Energy: 54%    Health: 100%

>l
Basecamp
Plaza Argentina Base Camp (4200m) for Mt. Aconcagua. The trail up to the summit begins here. It's a dangerous, but non-technical climb. There is a collection of ragtag temporary structures that form the Guardia's seasonal presence at the less popular Polish Route base camp. Brightly colored tents dot the plateau. The Polish Glacier looms in the distance, and a swift stream - the headwaters of the Vacas river flow from its base. There is an outhouse on the edge of camp. The weekly helicopter retrieval of the 50 gallon drum of waste is a highlight and one of the only things that marks civilized time.

--- Down here, each action requires 1 energy point. And without energy, your health will decrease 11 points per action. ---

You can see 'Basecamp Chest' (in which are an orange, a cliff bar, beef jerky, chicken jerky, an ice axe, crampons, a rope, a first aid kit, a tent (empty) and a chemical warming pack) here.

Current Load: 15%    Max Load: 100%            Energy: 53%    Health: 100%

I beg your pardon?

I beg your pardon?

>l
Basecamp
Plaza Argentina Base Camp (4200m) for Mt. Aconcagua. The trail up to the summit begins here. It's a dangerous, but non-technical climb. There is a collection of ragtag temporary structures that form the Guardia's seasonal presence at the less popular Polish Route base camp. Brightly colored tents dot the plateau. The Polish Glacier looms in the distance, and a swift stream - the headwaters of the Vacas river flow from its base. There is an outhouse on the edge of camp. The weekly helicopter retrieval of the 50 gallon drum of waste is a highlight and one of the only things that marks civilized time.

--- Down here, each action requires 1 energy point. And without energy, your health will decrease 11 points per action. ---

You can see 'Basecamp Chest' (in which are an orange, a cliff bar, beef jerky, chicken jerky, an ice axe, crampons, a rope, a first aid kit, a tent (empty) and a chemical warming pack) here.

Current Load: 15%    Max Load: 100%            Energy: 52%    Health: 100%

>sip water
Aaaaahh! Very refreshing. Only 5 sips left.

Current Load: 15%    Max Load: 100%            Energy: 61%    Health: 100%

>sip water
Aaaaahh! Very refreshing. Only 4 sips left.

Current Load: 15%    Max Load: 100%            Energy: 70%    Health: 100%

>sip water
Aaaaahh! Very refreshing. Only 3 sips left.

Current Load: 15%    Max Load: 100%            Energy: 79%    Health: 100%

>sip water
Aaaaahh! Very refreshing. Only 2 sips left.

Current Load: 15%    Max Load: 100%            Energy: 88%    Health: 100%

>sip water
Aaaaahh! Very refreshing. Only 1 sips left.

Current Load: 15%    Max Load: 100%            Energy: 97%    Health: 100%

>sip water
Aaaaahh! Very refreshing. Only 0 sips left.

Current Load: 15%    Max Load: 100%            Energy: 99%    Health: 100%

>sip water
Ooops... you're all out of slush.

Current Load: 15%    Max Load: 100%            Energy: 98%    Health: 100%

* * *

>sit
(on Chest1)
That's not something you can sit down on.

>take chest
That's fixed in place.

* * *

>sleep
There's no more time for rest, you've got some hiking to do.

Current Load: 0%    Max Load: 100%            Energy: 99%    Health: 100%

>n
Current Load: 0%    Max Load: 100%            Energy: 99%    Health: 100%

>sleep
Sleeping out in the open is a bad idea, you may want to find shelter. Are you sure you want to sleep here?

>y
You got some sleep, but it's pretty cold even down here. You're a 10% more tired than before.

Current Load: 0%    Max Load: 100%            Energy: 88%    Health: 100%

>sleep
Sleeping out in the open is a bad idea, you may want to find shelter. Are you sure you want to sleep here?

* * *

>sleep
There's no more time for rest, you've got some hiking to do.

Current Load: 0%    Max Load: 100%            Energy: 99%    Health: 100%

>open chest
You open 'Basecamp Chest', revealing an orange, a cliff bar, beef jerky, chicken jerky, a water bottle, an ice axe, crampons, a rope, a first aid kit, a tent and a chemical warming pack.

Current Load: 0%    Max Load: 100%            Energy: 98%    Health: 100%

>take water, beef, crampons, tent, aid kit
water bottle: Taken.
beef jerky: Taken.
crampons: Taken.
tent: Taken.
first aid kit: Taken.

Current Load: 75%    Max Load: 100%            Energy: 97%    Health: 100%

>take chicken
Taken.

Current Load: 85%    Max Load: 100%            Energy: 96%    Health: 100%

>go n
Before heading up to Camp1, you should at least bring food, water, shelter, and an ice axe.

Current Load: 85%    Max Load: 100%            Energy: 95%    Health: 100%

>take axe
Taken.

Current Load: 100%    Max Load: 100%            Energy: 94%    Health: 100%

>each orange
That's not a verb I recognise.

>eat orange
(first taking the orange)
You're at max capacity. At this elevation you're max load is 100% and you're currently holding 100%, but this item requires an additional 3%.

Current Load: 100%    Max Load: 100%            Energy: 93%    Health: 100%

>go n
Are you sure you want to go to Camp1? This hike will require 20 energy.

>y
You make the trek to Camp1 and arrive late in the evening.

Camp1
Camp 1 (4900m)  At 16,076 feet above sea level, Camp 1 is higher than most people have every climbed. It is higher than any peak in North America. It is just 1000 feet lower than Everest Base Camp in Nepal. Camp 1 is located at the top of the trail on a plateau. Aconcagua is not visible from here, but its sister, Mt. Ameguino's snowy peak looms above you. The camp is located several hundred meters from the glacial stream. There is no outhouse (you must bury your waste, away from any area that could contaminate the stream). Carrying water from the stream to boil for hydration and cooking is required. You can only carry part of what you need to Camp 2 on your first trip, so you must plan carefully. Climbers normally stay one night in Camp 1, then return to Basecamp for more supplies. There's a glacier between here and Camp 2, so you'll need an ice axe to climb it.

--- Here, each action requires 2 energy points. And without energy, your health will decrease 12 points per action. ---

Current Load: 100%    Max Load: 100%            Energy: 71%    Health: 100%

>i
You are carrying:
  an ice axe
  chicken jerky
  a first aid kit
  a tent
  crampons
  beef jerky
  a water bottle

Current Load: 100%    Max Load: 100%            Energy: 69%    Health: 100%

>inspect chest
That's not a verb I recognise.

>x chest
You can't see any such thing.

* * *

>open chest
You open 'Basecamp Chest', revealing an orange, a cliff bar, beef jerky, chicken jerky, a water bottle, an ice axe, crampons, a rope, a first aid kit, a tent and a chemical warming pack.

Current Load: 0%    Max Load: 100%            Energy: 98%    Health: 100%

>use first aid kit
Your health has increased a bit.

Current Load: 0%    Max Load: 100%            Energy: 100%    Health: 100%

>x chest
In 'Basecamp Chest' are an orange, a cliff bar, beef jerky, chicken jerky, a water bottle, an ice axe, crampons, a rope, a first aid kit, a tent and a chemical warming pack.

Current Load: 0%    Max Load: 100%            Energy: 99%    Health: 100%

* * *

>sleep
There's no more time for rest, you've got some hiking to do.

Current Load: 0%    Max Load: 100%            Energy: 99%    Health: 100%

>sleep
You close your eyes and awake at the crack of dawn.

You got some sleep, but it's pretty cold even down here. You're a 10% more tired than before.

Current Load: 0%    Max Load: 100%            Energy: 78%    Health: 100%

* * *

>sleep
There's no more time for rest, you've got some hiking to do.

Current Load: 0%    Max Load: 100%            Energy: 99%    Health: 100%

>y
You close your eyes... and suffer through a freezing night. Finally, you awake the next day at the crack of dawn.

You got some sleep, but it's pretty cold even down here. You're 10% more tired than before.

Current Load: 0%    Max Load: 100%            Energy: 89%    Health: 100%

>sleep
There's no more time for rest, you've got some hiking to do.

Current Load: 0%    Max Load: 100%            Energy: 88%    Health: 100%

>open chest
You open 'Basecamp Chest', revealing an orange, a cliff bar, beef jerky, chicken jerky, a water bottle, an ice axe, crampons, a rope, a tent and a chemical warming pack.

Current Load: 0%    Max Load: 100%            Energy: 87%    Health: 100%

>take water, chicken, axe, tent
water bottle: Taken.
chicken jerky: Taken.
ice axe: Taken.
tent: Taken.

Current Load: 60%    Max Load: 100%            Energy: 86%    Health: 100%

>go n
Are you sure you want to go to Camp1? This hike will require 20 energy.

>y
You make the trek to Camp1 and arrive late in the evening.

Camp1
Camp 1 (4900m)  At 16,076 feet above sea level, Camp 1 is higher than most people have every climbed. It is higher than any peak in North America. It is just 1000 feet lower than Everest Base Camp in Nepal. Camp 1 is located at the top of the trail on a plateau. Aconcagua is not visible from here, but its sister, Mt. Ameguino's snowy peak looms above you. The camp is located several hundred meters from the glacial stream. There is no outhouse (you must bury your waste, away from any area that could contaminate the stream). Carrying water from the stream to boil for hydration and cooking is required. You can only carry part of what you need to Camp 1 on your first trip, so you must plan carefully. Climbers stay one night in Camp 1, then return to Base Camp for more supplies. You have to bring the bare essentials - tent, sleeping bag, camp stove, food. You don't immediately need ice climbing equipment - mountaineering boots, crampons, ice ax, harness, helmet, rope. But you will eventually need to bring up to Camp 1, as it's needed at higher elevations.

--- Here, each action requires 2 energy points. And without energy, your health will decrease 12 points per action. ---

Current Load: 60%    Max Load: 100%            Energy: 64%    Health: 100%

>sleep
Sleeping outdoors is a bad idea - it's freezing! You should find shelter but it's totally up to you. Are you sure you want to sleep here?

>n
Current Load: 60%    Max Load: 100%            Energy: 62%    Health: 100%

>go s
It's dark out, and you need some sleep before making another trek.

Current Load: 60%    Max Load: 100%            Energy: 60%    Health: 100%

>sleep
Sleeping outdoors is a bad idea - it's freezing! You should find shelter but it's totally up to you. Are you sure you want to sleep here?

>y
You close your eyes... and suffer through a freezing night. Finally, you awake the next day at the crack of dawn.

You got some sleep, but it's pretty cold even down here. You're 10% more tired than before.

Current Load: 60%    Max Load: 100%            Energy: 48%    Health: 100%

>go s
Are you sure you want to go to Basecamp? This hike will require 15 energy.

>y
You make the trek to Basecamp and arrive late in the evening.

Basecamp
Plaza Argentina Base Camp (4200m) for Mt. Aconcagua. The trail up to the summit begins here. It's a dangerous, but non-technical climb. There is a collection of ragtag temporary structures that form the Guardia's seasonal presence at the less popular Polish Route base camp. Brightly colored tents dot the plateau. The Polish Glacier looms in the distance, and a swift stream - the headwaters of the Vacas river flow from its base. There is an outhouse on the edge of camp. The weekly helicopter retrieval of the 50 gallon drum of waste is a highlight and one of the only things that marks civilized time.

--- Down here, each action requires 1 energy point. And without energy, your health will decrease 11 points per action. ---

You can see 'Basecamp Chest' (in which are an orange, a cliff bar, beef jerky, crampons, a rope and a chemical warming pack) here.

Current Load: 60%    Max Load: 100%            Energy: 32%    Health: 100%

>go n
It's dark out, and you need some sleep before making another trek.

Current Load: 60%    Max Load: 100%            Energy: 31%    Health: 100%

>sleep
Sleeping outdoors is a bad idea - it's freezing! You should find shelter but it's totally up to you. Are you sure you want to sleep here?

>y
You close your eyes... and suffer through a freezing night. Finally, you awake the next day at the crack of dawn.

You got some sleep, but it's pretty cold even down here. You're 10% more tired than before.

Current Load: 60%    Max Load: 100%            Energy: 20%    Health: 100%

Your energy is low! You need food, water, or rest.

>eat
What do you want to eat?

>i
You are carrying:
  a tent
  an ice axe
  chicken jerky
  a water bottle

Current Load: 60%    Max Load: 100%            Energy: 19%    Health: 100%

>eat chicken
Your energy has increased a bit.

Current Load: 50%    Max Load: 100%            Energy: 43%    Health: 100%

>drink
What do you want to drink?

>drink water
Aaaaahh! Very refreshing. Only 6 sips left.

Current Load: 50%    Max Load: 100%            Energy: 52%    Health: 100%

>drink water
Aaaaahh! Very refreshing. Only 5 sips left.

Current Load: 50%    Max Load: 100%            Energy: 61%    Health: 100%

>drink water
Aaaaahh! Very refreshing. Only 4 sips left.

Current Load: 50%    Max Load: 100%            Energy: 70%    Health: 100%

>drink water
Aaaaahh! Very refreshing. Only 3 sips left.

Current Load: 50%    Max Load: 100%            Energy: 79%    Health: 100%

>drink water
Aaaaahh! Very refreshing. Only 2 sips left.

Current Load: 50%    Max Load: 100%            Energy: 88%    Health: 100%

>drink water
Aaaaahh! Very refreshing. Only 1 sips left.

Current Load: 50%    Max Load: 100%            Energy: 97%    Health: 100%

>go n
Before heading up to Camp1, you should at least bring food, water, shelter, and an ice axe.

Current Load: 50%    Max Load: 100%            Energy: 96%    Health: 100%

>open chest
That's already open.

Current Load: 50%    Max Load: 100%            Energy: 95%    Health: 100%

>x chest
In 'Basecamp Chest' are an orange, a cliff bar, beef jerky, crampons, a rope and a chemical warming pack.

Current Load: 50%    Max Load: 100%            Energy: 94%    Health: 100%

>eat orange
(first taking the orange)
Your energy has increased a bit.

Current Load: 53%    Max Load: 100%            Energy: 99%    Health: 100%

>take cliff
Taken.

Current Load: 59%    Max Load: 100%            Energy: 98%    Health: 100%

>take axe
You already have that.

Current Load: 74%    Max Load: 100%            Energy: 97%    Health: 100%

>take tent
You already have that.

Current Load: 94%    Max Load: 100%            Energy: 96%    Health: 100%

>go n
It's dark out, and you need some sleep before making another trek.

Current Load: 94%    Max Load: 100%            Energy: 95%    Health: 100%

* * *

>sleep
There's no more time for rest, you've got some hiking to do.

Current Load: 0%    Max Load: 100%            Energy: 88%    Health: 100%

>sleep
There's no more time for rest, you've got some hiking to do.

Current Load: 0%    Max Load: 100%            Energy: 87%    Health: 100%

* * *

>sleep
There's no more time for rest, you've got some hiking to do.

Current Load: 0%    Max Load: 100%            Energy: 88%    Health: 100%

>y
You got some sleep, but it's pretty cold even down here. You're a 10% more tired than before.

Current Load: 0%    Max Load: 100%            Energy: 89%    Health: 100%

* * *

>take backpack
You can't see any such thing.

>open chest
You open 'Basecamp Chest', revealing a water bottle, an ice axe, a tent, a backpack and an orange.

Current Load: 0%    Max Load: 0%            Energy: 99%    Health: 100%

>take backpack
Taken.

Current Load: 0%    Max Load: 100%            Energy: 98%    Health: 100%

>place orange in backpack
That's not a verb I recognise.

>put orange in backpack
(first taking the orange)
Try taking things once you're wearing a backpack. You can hold a lot more that way, but remember, the higher up you go the less you'll be able to carry.

Current Load: 0%    Max Load: 100%            Energy: 97%    Health: 100%

>i
You are carrying:
  a backpack (open but empty)

Current Load: 0%    Max Load: 100%            Energy: 96%    Health: 100%

* * *

>take tent
You can't see any such thing.

>open chest
You open 'Basecamp Chest', revealing a water bottle, an ice axe, a tent, a backpack and an orange.

Load: 0%  Energy: 99%  Health: 100%

>take tent
Taken.

Load: 0%  Energy: 98%  Health: 100%

>take water
You'll probably need a backpack to hold all that...

Taken.

Load: 0%  Energy: 97%  Health: 100%

>i
You are carrying:
  a water bottle
  a tent

Load: 0%  Energy: 96%  Health: 100%

* * *

>take water, cliff, chicken, beef, rope, first aid kit, tent, axe
You can't see any such thing.

* * *

>test me
>--> No test scripts exist for this game.

* * *

>wear backpack
You can't see any such thing.

>open chest
You open 'Basecamp Chest', revealing a water bottle, an ice axe, a tent, a backpack and an orange.

Current Load: 0%    Max Load: 0%            Energy: 99%    Health: 100%

>wear backpack
(first taking the backpack)
You're now wearing a backpack.

You've already got that on silly.

Current Load: 0%    Max Load: 100%            Energy: 98%    Health: 100%

* * *

>x basecamp
You can't see any such thing.

* * *

>x chest
You see nothing special about the chest.

>open chest
You open the chest, revealing a sleepsack.

* * *

>x chest
You see nothing special about the chest.

>open chest1
It isn't something you can open.

>open matchbox1
You open matchbox1, revealing an orange.

>open chest
You can't see any such thing.

>x chest
You can't see any such thing.

* * *

>x matchbox
You see nothing special about 'Matchbox'.

>open matchbox
You open 'Matchbox', revealing 5 matches.

>open Matchbox
You can't see any such thing.

* * *

>open matchbox
You open 'Matchbox', revealing 5 matches.

>x 'Matchbox'
In 'Matchbox' is 5 matches.

>open 'Matchbox'
That's already open.

>take match
You can't see any such thing.

* * *

>x self
As good-looking as ever.

Load: 0%  Energy: 99%  Health: 100%

>open chest1
You open Chest1, revealing an orange.

>eat orange
(first taking the orange)
Your energy has increased to 100%.

>x self
Health: 100%. Energy: 100%.